1 ContributorTop Groups of 2021 LyricsBTS - Butter
Maroon 5 - Memories
Imagine Dragons - Follow You
One Direction - Best Song Ever
Queen - Bohemian Rhapsody
The Beatles - Let It Be (Remastered 2009)
Måneskin - Beggin'
Arctic Monkeys - Why'd You Only Call Me When You're High?
Linkin Park - In the End
BLACKPINK - Ice Cream (with Selena Gomez)
Twenty One Pilots - Shy Away
$uicideboy$ - ...And to Those I Love, Thanks for Sticking Around
The Neighbourhood - Sweater Weather
Red Hot Chili Peppеrs - Scar Tissue
AC/DC - Thunderstruck
Black Eyed Pеas - I Gotta Feeling
OneRepublic - Someday
Metallica - Enter Sandman
Little Mix - Sweet Melody
Zé Felipe & Os Barões Da Pisadinha - Senta Danada
The Chainsmokers, ILLENIUM & Lennon Stella - Takeaway
Glass Animals - Heat Waves
TWICE - The Feels
Nirvana - Come As You Are
Migos - Straightenin
Banda MS de Sergio Lizárraga - La Casita
Reik & Maluma - Perfecta
Grupo Firme - Ya Supérame (En Vivo)
Green Day - Boulevard of Broken Dreams
5 Seconds of Summer - Youngblood
ABBA - Chiquitita
The Rolling Stones - Start Me Up (Remastered 2009)
Panic! At The Disco - High Hopes
Pink Floyd - Wish You Were Here (2011 Remaster)
Bob Marley & The Wailers - Is This Love
Guns N' Roses - Sweet Child O' Mine
Jorge & Mateus - Namorando Com Saudade
Internet Money - His & Hers (feat. don Toliver, Lil Uzi Vert & Gunna)
Tame Impala - Borderline
Wisin & Yandel, Chris Brown & T-Pain - Algo Me Gusta De Ti
Daft Punk - One More Time
Jonas Brothers - Sucker
Aventura & Bad Bunny - Volví
U2 - Beautiful Day
Bring Me The Horizon - DiE4u
Bon Jovi - It's My Life
Led Zeppelin - Whole Lotta Love (1990 Remaster)
Calibre 50 - A La Antigüita
Henrique & Juliano - Arranhão (Ao Vivo)
Stray Kids - ThunderousEmbed