1 ContributorNew Music Friday Christian 07/03/20 LyricsTasha Cobbs Leonard - Let It Fall (Live)
Housefires - Fresh Fire (Live) (feat. Tony Brown, Maryanne J. George)
We The Kingdom - Child Of Love
Sidewalk Prophets - I Believe It Now
ELEVATION RHYTHM - QUIET
PEABOD - Big Feelings (feat. Aklesso)
For All Seasons - Every Good Thing (Neon Feather Remix)
** Hyper Fenton - Sovereign (Your Name) (feat. Dennis Gorcea, George Horga Jr.)
JJ Heller - Beautiful Again
sxxnt. - Raise a Hallelujah (feat. Praise Lubangu, Trumpet Pete)
** All Nations Music - Bless Your Name (feat. Chandler Moore)
** Keith & Kristyn Getty - The Lord Is My Salvation (feat. Shane & Shane)
Equippers Worship - Holy Fire
Christon Gray - Beautiful Dreamer Remix (Remix) (feat. Propaganda)
** Chris Howland - Holy (Remix) (feat. ØM-53)
nobigdyl. - PARABOLIC!
Zander - Show Me Grace
Myron Butler & Levi - All Things Well
Tasha Cobbs Leonard - Hallelujah (You Get The Glory) (Live)
Davis John Patton - Ecclesiastes
Planetshakers - Champion (Demo)
NEEDTOBREATHE - Who Am I
Chris Tomlin - Who You Are To Me (feat. Lady A)
Apollo LTD - Rulers
Lecrae - Deep End
The Gray Havens - Rest
Pat Barrett - Lightning (feat. Harolddd)
Shane & Shane - Sometimes By Step
Dan Bremnes - Searching For Something (Acoustic) (feat. Stars Go Dim)
Kim Walker-Smith - Protector (Live)
Grace City - Another Day (feat. Anna Hallsten)
Matt Redman - Upon Him
Common Hymnal - Innocent Lives (feat. Bobby Alexandre, Mark Alan Schoolmeesters)
** James Fortune - Nobody Like Jesus (Radio Edit) (feat. Lisa Knowles-Smith)
Deitrick Haddon - I Can't Breathe
REVERE - Come And Tear Down The Walls (Live) (feat. David & Nicole Binion, Lee University Singers)
Chris Tomlin - Thank You Lord (feat. Thomas Rhett & Florida Georgia Line)
Local Sound - How I Love You
Life Center Worship - Hope for All
Nick & Becky Drake - Slingshot (feat. Worship For Everyone)
Ascent Project - Trust in You (feat. Matthew McGinley)
KXC - Fighting For My Heart (feat. Rich & Lydia Dicas)
Mission House - Good God (feat. Jess Ray, Taylor Leonhardt)
Gateway Worship - Give Me Your Peace (Radio Edit) (feat. Zac Rowe)
Rachael Nemiroff - Home
International Show & Rapzilla - big, GOD (feat. Scribe Music)
Retain - Echo (Retain Remix)
ØM-53 - Alpha (feat. Edu Linares)
Ross King - Clear the Stage 2020
Keith & Kristyn Getty - Facing A Task Unfinished
Myron Butler & Levi - We Are Not Ashamed (feat. Kim Burrell)
Jason Clayborn & The Atmosphere Changers - God Made It Beautiful (feat. Daria Raymore)
Skillet - Save Me (Reimagined)
Aretha Franklin - Never Gonna Break My Faith (feat. The Boys Choir of Harlem) (feat. The Boys Choir Of Harlem)
The Fisk Jubilee Singers - Glory / Stranger (feat. Derek Minor, Shannon Sanders)
Jon Reddick - The Power of Your Name (feat. Matt Redman)
Hillsong Worship - Awake My Soul (feat. Tasha Cobbs Leonard)
Jonathan Traylor - For The Wild Ones (feat. Adrion Butler)
RICHLIN - Love Like Thunder (feat. Ryan Stevenson)
Da' T.R.U.T.H. - A Greater Story (feat. Sam Collier, Tyra Scott)
SEU Worship - Freedom All Around (feat. David Ryan Cook)
Life.Church Worship - Heaven’s All Around
Jamie Grace - Live About It (lo-fi)
Q Parker - I Need You (feat. John P. Kee, Todd Dulaney, Tank, Jonathan McReynolds, Jacquees, Travis Greene, Ginuwine, Byron Cage, Montell Jordan, Raheem DeVaughn, Jason Nelson, Major, PJ Morton, Musiq Soulchild, Brian Courtney Wilson, Bobby V., Eric Dawkins, JK Howells, Mali Music, Alic Walls, Wingo, RL, Ted Winn, Pleasure P, Sammie, Zacardi Cortez, Ruben Studdard, Case, Marcus Devine, Lyfe Jennings, J. Holiday, Ruff Endz, Darwin Hobbs)
Dray Tate - A Change is Gonna Come (Remix) (feat. Mr. Talkbox, Melvin Williams)
C3LA Music - Move Your Heart + Rest Upon Us
The Worship Initiative - There's a River (feat. Shane & Shane)
Steven Curtis Chapman - That's My Dad
Dan Bremnes - The Way (Acoustic)
Sandra McCracken - I Will Sing
Ben Potter - Comforter II (feat. Laity)
John Tibbs - Make You Feel My Love
Planetshakers - Caught Up In Your Presence (Demo)
Coby James - Born Ready
Riley Clemmons - Over And Over (RUSLAN & Julie Lov Remix)
P. Lo Jetson - Goin' Up
Christon Gray - Beautiful Dreamer
Matt Stinton - There Is No Striving
Community Music - Nothing He Can't Do (feat. Meredith Andrews)
Canyon Hills Worship - Jesus My Treasure (Radio Edit)
Austin & Lindsey Adamec - This Is Where I Belong (Live)
Valley Creek Worship - You Bring the More (Live)
Alive City - Too Young
Mark & Sarah Tillman - Just Jesus
Paul McRae - Humble Beginnings
** John Mark Pantana - I Know Just What You Need (feat. Rebekah Autumn)
Matt Marvane - There is a Redeemer (Single Edit)
** Keith & Kristyn Getty - O Church Arise (feat. Shane & Shane)
Demetrius West - The Return (feat. Earnest Pugh)
Phillips - There Is A God (feat. Craig & Dean)
Josh Baldwin - Evidence (Radio Version)
Citizens - Light of Your Grace
** Mack Brock - I Lift My Eyes (Studio Version)
Natalie Grant - Praise You In This Storm
Rebecca St. James - Battle Is the Lord's (feat. Brandon Lake)
NONAH - The River Bows
Austin Stone Worship - In The Hands Of Christ My King
Mass Anthem - Stupid Deep / Sinking Deep
Jason Upton - Watching Over Me
Debora Sita - Hold My HeartEmbed