1 ContributorNew Music Friday 12/07/18 Lyricsbenny blanco - Roses (with Juice WRLD feat. Brendon Urie)
Marshmello - Project Dreams
XXXTENTACION - whoa (mind in awe)
Seeb - Grip
Cautious Clay - REASONS
Smooky MarGielaa - Flight To Memphis (feat. Chris Brown, Juicy J & A$AP Rocky)
Sneakk - Spray (feat. Tyga & YG)
Sody - Let You Know
Broken Bells - Shelter
SHY Martin - Just a Little Longer
benny blanco - Just For Us Pt. 2
Phoebe Bridgers - Friday I’m In Love - Recorded at Spotify Studios NYC
Kodak Black - Testimony
XXXTENTACION - One Minute (feat. Kanye West)
AFI - Back Into The Sun
Oliver Tree - Hurt
beabadoobee - If You Want To
Flipp Dinero - Feelin Like
Stephen Puth - Sexual Vibe
Astrid S - Closer
KYLE - Hey Julie! (feat. Lil Yachty)
Tone Stith - Good Company (feat. Swae Lee & Quavo)
Natalie Portman - Wrapped Up
Tourist - Hearts
American Authors - Neighborhood (feat. Bear Rinehart of NEEDTOBREATHE)
A Boogie Wit da Hoodie - Look Back At It
Gucci Mane - Cold Shoulder (feat. YoungBoy Never Broke Again)
RØMANS - Animals
Cassette Tapes - Another You
Lil Mosey - K For Christmas
Justin Jesso - Getting Closer
mxmtoon - porcelain
Ella Vos - Ocean
Rich The Kid - Splashin
Tina DeCara - Solo
HRVY - I Don't Think About You
Plested - Your Name
Zeina - Tear Drops
Dillistone - You Got Me
Luke Sital-Singh - Love is Hard Enough Without the Winter
Domo Genesis - Consecutive Normal Punches (feat. Buddy)
Luke Christopher - PREFER THE RAIN
Leven Kali - Thursday
Wisin & Yandel - Callao
Braison Cyrus - I'll Never Leave You
Echos - Revival
Jarami - Bahía
Gabrielle Aplin - December
Moonchild - Get To Know It
Mr. Probz - Praying To A God
Still Woozy - Habit
ZAYN - Good Years
Toro y Moi - Ordinary Pleasure
Kelsy Karter - Catch Me If You Can
Anderson East - This Too Shall Last (Stripped)
LP - When I'm Over You
Toby Keith - Don't Let the Old Man In
FANNYPACK - Simple
Jacob Collier - Every Little Thing She Does Is Magic
Don Diablo - I Got Love (feat. Nate Dogg)
Semi-Attractive Boy - B L A C K S T O N E
Fleurie - Love Has No Limits
Harlo - Burning Up
Ambar Lucid - Candy
Chase Atlantic - LIKE A ROCKSTAR
Roman the Cartoon - Cruella de Vil
BAYNK - Off Limits
R3HAB - All Into Nothing
OMI - As Long As I'm With You
Christine and the Queens - The walker – Recorded at RAK Studios, London
Ice Cube - That New Funkadelic
MorMor - Pass the Hours
adam&steve - younger
Galactic - Clap Your Hands (feat. Miss Charm Taylor)
The Steel Woods - Southern Accents
Michael Franti & Spearhead - Nobody Cries Alone
TS Graye - Honestly
Adam Melchor - Real Estate
Saba - Papaya
lil aaron - FUCK CHRISTMAS
Madism - Incapable
sakehands - GOOODBYE FOREVER (Instupendo Remix)
DaVido - Wonder Woman
Deaf Havana - Cr33pin
CADE - Strip Club (feat. Lil Aaron)
Hardwell - How You Love Me (feat. Conor Maynard & Snoop Dogg)
Edana - Slow Motion
Vulfpeck - Half of the Way
The Americanos - Money On You
Sinead Harnett - Lessons
Hayleau - Thats Life
Stafford Brothers - KNOCK
O.T. Genasis - Bae
BLOXX - Sea Blue
Barcenilla - Timeless
Bristol Best - Out of My MindEmbed