1 ContributorNew Music Friday 2/28/20 LyricsLady Gaga - Stupid Love
Lil Baby - Live Off My Closet (feat. Future)
SZA - Theâ€…Otherâ€…Side (from Trollsâ€…World Tour)
Pink Sweat$ - 17
Jeremy Zuckerâ€…- not ur friend
JhenÃ© Aiko - Happiness Over Everything (H.O.E.)âŸ(feat.âŸFutureâŸ& Miguel)
AminÃ© -âŸShimmy
J Balvin -âŸRojo
Surfaces - Take It Easy
Martin Garrix - Drown (feat. Clinton Kane)
Marshmello - Crusade
Mabel - Boyfriend
Lil Baby - Heatin Up (feat. Gunna)
PARTYNEXTDOOR - SPLIT DECISION
Phoebe Bridgers - Garden Song
100 gecs - ringtone (Remix) [feat. Charli XCX, Rico Nasty, Kero Kero Bonito]
Swae Lee - Someone Said
Disclosure - Tondo
CÃ©line Dion - Wicked Game - Recorded at Electric Lady Studios, NYC (feat. Chris Isaak)
Delacey - Cruel Intentions
Kenny Mason - Metal Wings
Bryce Vine - Baby Girl
Perfume Genius - Describe - Edit
Ant Saunders - u know it's real
Ant Clemons - Aladdin
NLE Choppa - 100 Shots
2 Chainz - NO TV
BabyJake - Confidant
Max Leone - Cautious
Evie Irie - Over Him
Lila Drew - locket
Ally Brooke - Fabulous
Astrid S - I Do
Kelsea Ballerini - hole in the bottle
Keith Urban - God Whispered Your Name
Malia Civetz - Broke Boy
RIZ LA VIE - Tesla
G Herbo - PTSD
Kash Doll - Wake Up
Kid Ink - Look At That
Diana Gordon - Rollin
[JAWNY - Anything You Want] ğŸš
MAX - Where Am I At
Taylor Janzen - I Feel A Darkness
SHY Martin - Still the Same (feat. Boy In Space)
Soccer Mommy - bloodstream
Christine and the Queens - I disappear in your arms - bonus
Caribou - New Jade
Burna Boy - Odogwu
Young Nudy - Blue Cheese Salad
Princess Nokia - Green Eggs & Ham
Gorillaz - DÃ©solÃ© (feat. Fatoumata Diawara)
Jessie Ware - Spotlight - Single Edit
Nea - Dedicated
Jonas Blue - Mistakes
Loud Luxury - Nights Like This
Sonny Fodera - Before U
Wisin & Yandel - Ganas de Ti
Masiwei - Prince Charming
DJ Drama - 350
Lianne La Havas - Bittersweet
GRAACE - Hard to Say
[Medasin - Get By] ğŸš
Goth Babe - The River
Real Estate - The Main Thing
Yung Lean - Boylife in EU
[DJ Esco - Primetime] ğŸš
[YFN Lucci - Freestyle (feat. Bandhunta Izzy)] ğŸš
[Bantu - Stretch] ğŸš
Jonah Mutono - 1949
Harry Hudson - Let Me
The Hunna - Cover You
Hailey Whitters - All the Cool Girls
Filmore - Blue Skies
ren - i drive me mad
Adam Melchor - 30 MINUTES
Mk.gee - cz

[VOILÃ€ - 4GET] ğŸš
[Salt Cathedral - PARIS] ğŸš
[PLS&TY - I Miss You] ğŸš
Noga Erez - VIEWS
Yung Mal - Blake Griffin
Tm88 - RR
[2KBABY - FAXTS] ğŸš
Loote - This Is How U Feel
Ben Kessler - Right Here Right Now
Raissa - ANGEL ENERGY
Jensen McRae - Wolves
Henry Jamison - Still Life
[Briston Maroney - The Garden] ğŸš
HOKO - OK OK
DREAMERS - Heat Seeker

[Delly - Medusa] ğŸš
[N7 - Hot Head] ğŸš
Maty Noyes - Love Don't Cost A Thang
Liv.e - LazyEaterBetsOnHerLikeness
Chiiild - Pirouette
RMR - RASCALEmbed Drown (feat. Clinton Kane) Drown (feat. Clinton Kane) Martin Garrix;Clinton Kane progressive-house