1 ContributorNew Music Friday 08/19/22 LyricsBLACKPINK - Pink Venom
Internet Money, Lil Tecca - Falsetto (feat. Lil Tecca)
Zedd, Maren Morris, BEAUZ - Make You Say
Demi Lovato - 29
Offset - 54321
Anitta, Missy Elliott - Lobby
Panic! At The Disco - Don't Let The Light Go Out
Jean Dawson - THREE HEADS*
Tink - Opposite
Feid - Feliz Cumpleaños Ferxxo
Tyler Hubbard - Dancin’ In The Country
Lukas Graham, Khalid - Wish You Were Here (feat. Khalid)
bbno$ - sophisticated
Aitch, Ed Sheeran - My G (feat. Ed Sheeran)
Ruel - YOU AGAINST YOURSELF
Maya Hawke - Sweet Tooth
Kane Brown - Go Around
42 Dugg - IDGAF
Tank, Chris Brown - See Through Love (feat. Chris Brown)
Stephen Sanchez - See The Light
Bazzi - Heaven
Daya - Hеr
Dayglow - Deep End
Pheelz, Davido - Electricity
Kenny Mason- Dip! (feat. DavidThеTragic)
Cautious Clay - Camp Anonymous
Blake Shelton - No Body
Macklemore, Windser - MANIAC (feat. Windser)
chloe moriondo - Fruity
44phantom - don't sleep, repeat (feat. Machine Gun Kelly)
Key Glock - From Nothing
Larry June - Don't Check Me
Red Hot Chili Peppers - Tippa My Tongue
The Backseat Lovers - Growing/Dying
Johnny Orlando, BENEE - fun out of it ☑️
Maisie Peters - Good Enough
Jack Kays - Wish You Well
RealestK - Leave Me Alone
YBN Nahmir - Pip N' Walk
2Rare, Lil Durk - Q-Pid
88rising, MILLI - Mind Games (feat. Jackson Wang)
SEB - 3am in nyc
EMELINE - STRUT
thuy - playing tricks
serpentwithfeet - I'm Pressed
Chief Keef - Chief So
Stunna Gambino, Lil Perco - Self Worth (feat. Lil Perco)
Tayo Sound, Rudimental - Hide And Seek
The Struts - Fallin' With Me
flipturn - Sad Disco
Peter McPoland - Tonight
Fiji Blue - No Ties
Lost Frequencies - Chemical High
Camilo, Grupo Firme - Alaska
Thee Sacred Souls - Lady Love
Eric Church - Lone Wolf
Bailey Zimmerman - Where It Ends
Sara Kays - Watching TV
Juliana Madrid - Pretend
Young Saab - LOOK AWAY (feat. Roméo & RMR)
Hit-Boy - Fire Proof
LUCKI - COINCIDENCE
Avenoir - Shameless
Julión Álvarez Y Su Norteño Banda - Que Te Vaya Bien
Kolby Cooper - Are We On Fire
Allison Russell - You're Not Alone (Feat. Brandi Carlile)
Blondshell - Sepsis
Chloe George - Runaway Blue
Emei - Trust Issues
LØLØ - u turn me on (but u give me depression)
Seafret - Running Out of Love
LP Giobbi, Caroline Byrne - Forever And A Day
TobyMac - Fire's Burnin' (feat. Cory Asbury)
B.o.B - Blue
Kali - Wet
Rook Monroe - I Did Drugs For You
The Wombats - Is This What It Feels Like to Feel Like This?
Ross Copperman - Secrets
Charlie Burg - Dancing Through The Mental Breakdown
Lecx Stacy - Took My Time (feat. rei brown & sam.sts)
yvngxchris, DC The Don - QuikkSkope (feat. DC The Don)
I Prevail - Self-Destruction
Five Finger Death Punch - The End
grandma - soft-glow ☑️
Olivia Knox - Flying
Lissie - Sad
Corey Kent - Hood of That Car
Greentea Peng - Look To Him
Swavay - FACES - but like the one the label made me do
⣎⡇ꉺლ༽இ•̛)ྀ◞ ༎ຶ ༽ৣৢ؞ৢ؞ؖ ꉺლ - ()vȯ)) ̷̨ʅ(۝ʅ(Ɵʅ():::()̵̳̗̊(Ɵʅ()vȯ)) ̷̨ʅ
CLIPZ - No Time (feat. Nia Archives, Beenie Man, Cristale & ShaSimone)
The Last Artful, Dodgr - Whiteclaw
Nick Hakim - Happen
Bonnie Kemplay - Was it obvious?
Grimm Lynn - Slow Jam
Jay Wheeler, El Alfa, DJ Nelson - No Confío
OMB Peezy, DJ Drama, - Real Shit (feat. Morray)
Early James - If Heaven Is A Hotel
Ben Burgess - Heartbreak
Beauty School Dropout, Mark Hoppus - ALMOST FAMOUSEmbed