3 ContributorsNew Music Friday 05/18/18 LyricsPharrell Williams & Camila Cabello - Sangria Wine
Clean Bandit - Solo (feat. Demi Lovato)
Lil Baby & Drake - Yes Indeed
KYLE - Babies (feat. Alessia Cara)
Tiësto & Dzeko - Jackie Chan (feat. Preme & Post Malone)
Maluma - Hangover (feat. Prince Royce)
Jay Rock - WIN
OneRepublic - Start Again (feat. Logic)
Diplo, French Montana & Lil Pump - Welcome to the Party
BTS - FAKE LOVE
Shawn Mendes - Where Were You In The Morning?
Christina Aguilera - Fall In Line (feat. Demi Lovato)
Disclosure - Ultimatum - Edit (feat. Fatoumata Diawara)
Sam Hunt - Downtown's Dead
Kevin Gates - Let It Sing
Christine and the Queens - Girlfriend (feat. Dâm-Funk)
Jennifer Lopez - Dinero (feat. DJ Khaled & Cardi B)
Lil Peep - 4 Gold Chains (feat. Clams Casino)
Chelsea Cutler - The Reason
Dan + Shay - Speechless
Russ - Back To Life
NAV - Faith (feat. Quavo)
James Bay - Just For Tonight
NIKI - Dancing with the Devil
Steve Aoki - Pretender (feat. Lil Yachty & AJR)
YUNGBLUD - Falling Skies (feat. Charlotte Lawrence)
Bella Thorne - B*TCH I'M BELLA THORNE
G Flip - Killing My Time
DJDS - I Get By (feat. Amber Mark & Vory)
Backstreet Boys - Don't Go Breaking My Heart
Cheat Codes & DVBBS - I Love It
​for KING & COUNTRY - joy.
Nick Grant - Black Woman (feat. Stacy Barthe)
Yellowclaw - Bittersweet (feat. Sofia Reyes)
Hillsong Young & Free - Let Go
Alex Da Kid - Go (feat. H.E.R. & Rapsody)
Haley & Michaels - High Note
Carlie Hanson - Mood
Parquet Courts - Freebird II
Tash - I Lied
Galantis - Spaceship (feat. Uffie)
Temi Oni - Pull Up On You (feat. Tierra Whack)
Kris Wu - Like That
Riton & Kah-Lo - Ginger
Tyga - Taste (feat. Offset)
Brandon Ray - Bring Your Love Back
Mitski - Geyser
DallasK - Recover
Kevin George - LA DI DA
Yoshi Flower - Woke
Cautious Clay - French Riviera
Bullet For My Valentine - Letting You Go
Wifisfuneral - Juveniles (feat. YBN Nahmir)
Oli Fox - Cruel
Now, Now - Can't Help Myself
Conrad Sewell - Healing Hands
Philthy Rich - My Shit (feat. Tee Grizzley)
Eves Karydas - Couch
Lykke Li - utopia
Sophia Black - Blessed (feat. LunchMoney Lewis)
Stefflon Don - Senseless
Nine Inch Nails - God Break Down the Door
Kodak Black - Mama (feat. Jadakiss & TXS)
Betty Who - Taste
​jesse saint john - FAKE IT
SHAED - Trampoline
Jeremy Zucker & Chelsea Cutler - better off (filous remix) (feat. filous)
Ghost - Dance Macabre
Diana Gordon - Kool Aid
Opia - Four Winds
Clara Mae & Jake Miller - Better Me Better You
Courtney Barnett - Charity
MAJOR. - Better With You in It
03 Greedo - High Off Me (feat. Yung Bans)
Tom Grennan - Barbed Wire
Lord Huron - The Night We Met (feat. Phoebe Bridgers)
Just Loud - Electrified
​morgxn - vital (feat. BASECAMP)
Big Shaq - Man Don't Dance
The Dead Tongues - Won't Be Long
AS IT IS - The Wounded World
Amanda Shires - Leave It Alone
Clutch - Gimme the Keys
Johnny Balik - Shine
Claptone - Birdsong (feat. Zola Blood)
Ray LaMontagne - To the Sea
Mary Lattimore - Never Saw Him Again
​ilo ilo - wait
Johnny Orlando & Mackenzie Ziegler - What If
​alayna - Sweet Soul
Devendra Banhart - Shown and Told
Cheap Trick - The Summer Looks Good On You
Violet Days - Just a Little
Nick Mulvey - Punta Cometa (Dancing For The Answers Alt Version)Embed