12 ContributorsJune 2022 Singles Release Calendar Lyrics6/1
Ahmad Anonimis - "Can’t Wake Up" ft. Trilly
Amenazzy - "Hey Chanty"
BLK ODYSSY, Benny the Butcher & George Clinton - "BENNY'S GOT A GUN"
Calum Scott - "Boys in The Street"
CXRPSE - "BOTTOMLESS PIT"
Danny Beau - "MY SUMMER"
Denzel Curry & Key Glock - "Walkin' (Remix)"
Eli Fross - "Menace" ft. Fredo Bang
KT Tunstall - "Canyons"
Maggie Rogers - "Want Want"
Maisie Peters - "Cate's Brother (Matt's Version)" ft. Matt Maltese
María Becerra - "OJALÁ"
​midwxst - "​sidelines"
MISSIO - "Failure to Comply"
MISSIO - "#gimmeakiss"
MISSIO - "I Wanna Fight and You Know It"
Muse - "Will of the People"
MYA - "TAZA TAZA"
Nikone & Lionware - "Si Vuelves Tarde"
Panic! at the Disco - "​Viva Las Vengeance"
Paolo Nutini - "Shine a Light"
Pepe : Vizio - "Pides Demasiao"
Phoenix - "Alpha Zulu"
Rei & Quevedo - "FERNET"
Sarah Close - "Words Will Never Do"
She & Him - "Wouldn't It Be Nice"
Vance Joy - "Every Side Of You"
Yeah Yeah Yeahs - "Spitting Off the Edge of the World" ft. Perfume Genius
Yo Gotti, Moneybagg Yo & CMG The Label - "Big League" ft. Lil Poppa & Mozzy
6/2
Alex Sensation & Justin Quiles - "Te Veré"
Blunted Vato - "Normal"
Chema Rivas - "Fiel"
Chris Andrew - "A Tu Nombre"
Duki - "Antes de Perderte"
George Ezra - "I Went Hunting"
Juliette - "Solar"
Lasso - "Ojos Marrones"
Nikki Lane - "First High"
​sangiovanni & Aitana - "mariposas"
Since99 - "Like Yao"
Tiago PZK & Ozuna - "Nos Comemos"
Squash - "Don Dada"
Yuridia - "¿Con Qué Se Pega Un Corazón?"
6/3
almost monday - "sun keeps on shining"
Ana Mena - "Mezzanotte"
Asmir Young - "Si Supieras"
AViVA - "LONELY"
Betty Who - "Blow Out My Candle"
BigKayBeezy - "Outta Nowhere" ft. Shoebox Baby
B-Lovee & Coi Leray - "Demon"
BONES & drew the architect - "PackRippedOpen"
Brent Cobb - "Wild And Blue"
Brooklyn Queen - "Throw Sum"
Clara - "Weirdo"
Clinton Kane - "14"
CXRPSE - "JUMPIN IN THE PIT FREESTYLE"
Dagny - "Brightsider"
De La Ghetto & Rauw Alejandro - "Loco Por Perrearte (Remix)"
EDEN - "Modern Warfare"
Erubey - "Perreito en L.A."
GALE - "Problemas"
Goth Babe - "Taking Over the Sun"
Gucci Mane - "Mrs. Davis"
Hotboii - "WTF"
India Shawn - "EXCHANGE"
Jubël - "Diamonds" ft. Aleyna Tilki
Julieta Venegas - "Caminar Sola"
KA$HDAMI - "Famine" ft. XLOVCLO
Kasabian - "CHEMICALS"
Kash Doll, Rubi Rose & DreamDoll - "Abow" ft. ShantiiP
Kayzo - "Poser" ft. conner
KB Mike - "Need U" ft. Scorey
kurtains - "no magician"
Lakeyah - "Mind Yo Business" ft. Latto
lentra - "out of the blue"
Logic - "Bleed It"
Lola Indigo - "AN1MAL"
Lola Marsh - "Love Me on the Phone"
Lost Frequencies & James Arthur - "Questions"
Louie Ray - "P.Y.C.O"
Lous and The Yakuza - "Monsters"
Lucho SSJ & ARÓN - "Que Dios Me Perdone"
Maggie Lindemann & Siiickbrain - "break me!"
Marc Seguí & Rusherking - "360 (Remix)"
Masicka - "Tom Brady Freestyle"
Mikey Polo - "Great Xscape+++"
Monsieur Nov - "Entre Nous"
​moon tang - "i hate u"
Morelli - "Todo"
MUNA - "Sometimes"
NateWantsToBattle - "Bring Back (From ”The Rising of the Shield Hero”)"
NextYoungin & SpainDaGoat - "Harry Potter"
Nicole Favre, Aczino & Sabino - "Mala Manía"
NIKI - "Before"
Niko Rubio - "Over for Real"
Paula Cendejas - "​x ti"
Pitou - "Big Tear"
Polo G - "Distraction"
Real Boston Richey & Lil Durk - "Keep Dissing 2"
Reneé Rapp - "Tattoos"
Rowdy Rebel - "Woo Nina"
Rytikal - "Bang Bang"
Sada Baby - "2 Freaks" ft. Snoop Dogg
SIDEPIECE & Lee Foss - "One, Two Step"
Skibs - "The Tao Pt. 1"
Skillibeng - "Whap Whap (Remix)" ft. French Montana & Fivio Foreign
Skylar Stecker - "Know It’s Wrong"
St. Vincent - "Funkytown"
Stan Walker - "Feelings" ft. The Kings
Swae Lee & Diplo - "Tupelo Shuffle"
thea wang - "Word On The Street"
Thouxanbanfauni & Matt Ox - "Tragic"
Tory Lanez - "Wait for You (Freestyle)"
YBN Nahmir - "Dead Wrong"
Yungeen Ace - "Where They At"
6/4
Christian Nodal - "Girasol"
EL NOBA, Callejero Fino & Juanka - "Tamo Chelo (Remix)" ft. Dinero en el Beat, DT.Bilardo, Kaleb Di Masi & L-Gante
​wolfacejoeyy - "scars"
6/5
Hook - "ur first tattoo was a animal"
6/6
All Time Low - "Blinding Lights"
Cat Burns - "Go (Sam Smith Remix)" ft. Sam Smith
Darren Hayes - "Poison Blood"
Denzel Curry - "1st Quarter" ft. REASON
Josh Levi - "DON'T THEY (REMIX)" ft. Normani
Phoebe Green - "Sweat"
6/7
645AR - "Litty" ft. Rico Nasty
Editors - "Karma Climb"
Inhaler - "These Are The Days"
Mike Dimes - "Home (Remix)" ft. JID
Party Favor - "Hollow" ft. DeathbyRomy
Regina Spektor - "Loveology"
REY GWEN - "Static Electricity"
Robbie Williams - "Angels (XXV)"
Shygirl - "Come For Me"
Wet - "I'm Not Her"
6/8
盧瀚霆 (Anson Lo) - "King Kong"
Apel8 - "My Bloody Nails" ft. Powers Pleasant, ZillaKami
BabyTron - "Caught An Opp" ft. TrDee
Beach Bunny - "Entropy"
Bizarrap & Villano Antillano - "Villano Antillano: Bzrp Music Sessions, Vol. 51"
Danger Mouse & Black Thought - "Because" ft. Joey Bada$$, Russ & Dylan Cartlidge
Dende - "Block Me"
iii & 陳健安 (On Chan) - "雷公 (Thunderless)"
Dylan Fraser - "It Took A Lot To Get To This"
flowerovlove - "Hannah Montana"
iann dior - "Live Fast Die Numb"
Jack White - "If I Die Tomorrow"
King Princess - "Cursed"
King Princess - "Too Bad"
Lil Maru - "Heartless"
Marian Hill - "i think you know" ft. Steve Davit
Metric - "What Feels Like Eternity"
Miloe - "Floating"
Nina Nesbitt - "Pressure Makes Diamonds"
ODESZA - "Wide Awake" ft. Charlie Houston
PACKS - "​​don’t go for the goats milk"
Pale Waves - "Reasons to Live"
Pixey - "Come Around (Sunny Day)"
Pixies - "There's a Moon On"
Rae Sremmurd - "Denial"
Rich Homie Quan - "Still Sinning"
Shady Blu - "Jealousy"
Shelley FKA DRAM - "Chocolate Covered Strawberries"
SwaVay - "JUGG"
The Aces - "Girls Make Me Wanna Die"
Zakhar - "Fly Away"
Young King Slaton - "AnyTime, AnyPlace (Freestyle)"
6/9
Bag Raiders - "Never Forget"
Betzabeth - "Ahora Es Ella"
Black Birdie - "body"
Carlos Feria - "No te creo"
黃妍 (Cath Wong) - "世界以痛吻我而我歌唱 (Kiss, Pain, Sing)"
FMK - "De Vacaciones"
Freddie Dredd - "Wrath"
Halsey - "So Good"
Imani Williams - "Fuck Alone"
Kevin Gates - "Super General (Freestyle)"
Kita Alexander - "Storm"
Lebra Jolie - "Spring, Summer"
Marcianeke - "Calle y Pistola"
Mati Gómez - "Prometí"
Mere Raj - "​inmyhead"
MOTHICA - "BEDTIME STORIES"
MOTHICA - "BLOOD"
Nina - "10 noches"
Pabllo Vittar - "Mais Uma Voz"
Paty Cantú - "Bailo Sola"
Princess Nokia - "Diva"
Sebastián Yatra - "TV"
Soccer Mommy - "newdemo"
6/10
$UICIDEBOY$ - "Escape from BABYLON"
10KDunkin - "CLIQUIN UP"
2Tone - "Should Go Home"
Alejo & Young Miko - "Un Poquito"
Andrew Garden - "it hurts to change"
Ant Saunders - "Camaro"
Arizona Zervas & 24kGoldn - "OH MY LORD"
Bailey Zimmerman - "Rock and A Hard Place"
Bastille - "Remind Me"
Benjamin Ingrosso - "Dancing on a Sunny Day"
Betta Lemme - "Rumours"
Big Time Rush - "Fall"
Carmen DeLeon - "Mala Memoria"
Cate - "Ruin"
Cecilia Castleman - "Lonely Nights"
Chris Lane & Lauren Alaina - "Dancin' In the Moonlight"
Chronic Law - "You"
Cochise - "TURN IT UP"
Coi Leray - "The One"
Capella Grey - "OT" ft. Ty Dolla $ign
Consequence - "BLOOD STAIN"
Craig David - "G Love" ft. Nippa
Dax - "Dear Alcohol Remix" ft. Elle King
DDG - "Storyteller"
Demi Lovato - "SKIN OF MY TEETH"
Doodie Lo & Worldwide Hustle Devoo - "Zip Lock"
Eddie Benjamin & Alessia Cara - "Only You"
​Eizander - "Mantengo"
elijah​ woods - "​ilu"
Elisama - "Speaker"
Fitz and The Tantrums - "Sway"
French Montana & Harry Fraud - "Drive By" ft. Babyface Ray
Futuristic - "Gucci"
G Perico - "That’s My Dawg"
Greentea Peng - "Stuck In The Middle"
Guapdad 4000 - "Pose" ft. Wiz Khalifa & Curren$y
Gyakie - "SOMETHING"
HAEVN - "Trade it for the Night"
​iyla - "2LATE"
J.I the Prince of N.Y - "Riot"
Jacob Banks - "By Design [Evel Knievel]"
Jacob Collier - "Never Gonna Be Alone" ft. John Mayer & Lizzy McAlpine
Jaden Michaels - "Wrong"
Jaira Burns - "Daytime"
JGreen - "Everywhere"
Jimmie Allen - "settle on back"
Jimmy Eat World - "Something Loud"
Joji - "Glimpse of Us"
Joss Favela - "700 Días"
Kameron Marlowe - "Girl On Fire"
Kid Cudi - "Do What I Want"
Kyle Gee - "Revenge"
Leslie Shaw - "Poderes"
Lily Rose - "I'd Be You"
LINK - "I Belong to You"
Lissie - "Flowers" ft. Bre Kennedy
Lizzo - "Grrrls"
Logic - "Breath Control" ft. Wiz Khalifa
LOVA - "One Too Far"
Machine Gun Kelly & glaive - "more than life"
Mallory Merk - "Thorns"
Maluma & Chencho Corleone - "Nos Comemos Vivos"
Manu Manzo - "PAELLA"
Marshmello & Khalid - "Numb"
Metteson - "Never Let Me Go"
Mia Rodriguez - "Superglue"
Miya Folick - "Ordinary"
Montell Fish - "Hollow Love"
Mr Eazi - "Legalize"
Muni Long & Saweetie - "Baby Boo"
Nardo Wick - "Riot"
Nicole Acosta - "Home"
NLE Choppa - "Apart From Me"
Nohemy - "Tuya"
Paloma Ford - "Bentley Truck"
PEDRO SAMPAIO, Anitta & Dadju - "DANÇARINA (Remix)" ft. Nicky Jam & MC Pedrinho
Pharrell Williams - "CASH IN CASH OUT" ft. 21 Savage & Tyler, The Creator
PLUM-BLOSSOM - "Imagine being Overrated"
R3HAB & Amy Shark - "Sway My Way"
Rah Swish & Don Q - "Rolling Stone"
Ron Suno - "What They Gon Say (Remix)" ft. Rowdy Rebel
Rubi Rose - "Wifey"
Ryan Trey - "Only Us" ft. Babyface Ray
Rylo Rodriguez - "Benz Truck"
​salem ilese, Alan Walker & Abdul Cisse - "PS5 (Fortnite Battle Pass Gamer Remix)"
Saucy Santana - "Booty" ft. Latto
Seeb & Julie Bergan - "Always Will"
Sharlene & Corina Smith - "Brutal"
Skeng - "Limited Edition"
Skibs - "Rise & Fall"
Smash Mouth - "Never Gonna Give You Up"
​SSGKobe - "​shoota"
Steve Aoki & Taking Back Sunday - "Just Us Two"
Surfaces - "What's Been On Your Mind?"
Tank - "Slow" ft. J. Valentine
Teddy Swims - "2 Moods"
The Chainsmokers & Ship Wrek - "The Fall"
The Rasmus - "Rise"
Thouxanbanfauni - "ROWDY" ft. MDMA & DP THE KID
Tom Speight - "Roll the Dice Again"
Unlike Pluto - "Fata Morgana"
UnoTheActivist - "PAY UP!"
Violet Days - "First Times"
Wendigo - "Searching For You" ft. BRUHMANEGOD, JOHNNASCUS, CXRPSE, MKULTRA & CHRIST DILLINGER
Yung Gravy - "Betty (Get Money)"
6/11
Jackboy - "Havin My Way"
6/13
iayze - "AKs & ARs"
陳柏宇 (Jason Chan) - "墜落 (Dare To Fall) (Novel Fergus Remix)" ft. Novel Fergus
JID - "Freestyle 29"
Soulja Boy - "Shit Talker"
6/14
Biig Piig - "FUN"
BRELAND - "Natural"
Cub Sport - "Always Got The Love"
Dry Cleaning - "Don't Press Me"
Duwap Kaine - "Tonight"
Foals - "Crest of the Wave"
Jess Connelly - "Better"
Julia Jacklin - "I Was Neon"
LUCKI - "Y NOT?"
Röyksopp - "Sorry" ft. Jamie Irrepressible
Selfmxdebless - "P.J.K.Y.$"
Simple Minds - "Vision Thing"
6/15
Bananarama - "Masquerade"
beabadoobee - "10:36"
Ben Harper - "We Need to Talk About It"
C.R.O, Nahuel The Coach & Nath - "Hagámoslo De Nuevo"
Carlos Jean & John Martin - "Ride"
Cautious Clay - "Puffer"
Gabrielle Aplin - "Call Me"
Highway - "Next Weekend"
Ingrid Andress - "Pain"
Jay Fizzle - "Last Song"
Kadhja Bonet - "JGS"
Marlon Williams - "Thinking Of Nina"
New Hope Club - "Getting Better"
New Hope Club - "Girl Who Does Both"
Powers Pleasant - "Overseas" ft. Bas, Maxo Kream, Erick the Architect & Kenny Mason
Röyksopp - "Unity" ft. Karen Harding
Santigold - "Ain't Ready"
Seaforth & Sean Kingston - "Queen of Daytona Beach"
Selfmxdebless - "GoUpWtfAreYouDoing?"
Valentina Zenere - "Cero Coma"
Young the Giant - "Wake Up"
6/16
Aya Nakamura - "Méchante"
bLAck pARty - "On My Way"
Camilo & Alejandro Sanz - "NASA"
DAAZ & Ingratax - "Necesito un Break de Tanta Pendejad*"
Eminem - "The King and I" ft. CeeLo Green
FABRO, MYA & CNCO - "Suelta, Sola y Tranquila (Remix)"
FKA twigs - "Killer"
Jon Z & Morad - "Gol"
Key Glock - "712AM"
Kim Loaiza & Mr. Pig - "Pa' Eso Se Hizo"
Llane & Danny Ocean - "Fino"
Luana - "Por Ti"
MoStack - "Fake Fake Fake"
Pitizion - "A Tiempo"
Polimá WestCoast, Pailita & Feid - "ULTRA SOLO Remix" ft. Paloma Mami & De La Ghetto
Ramon Vega & Michelle Macie - "eScoRpiÓn"
Robleis - "IDIOTA"
Selfmxdebless - "WhatMakesyouDie?"
st. Pedro - "Esa Noche"
Steve Lacy - "Mercury"
Symon Dice, Kaleb Di Masi & LATENIGHTJIGGY - "Pelinegra"
Tayc - "Laisse moi te dire" ft. Hamza
Tei Shi - "GRIP"
Two Door Cinema Club - "Wonderful Life"
Zilo - "Underwater"
6/17
Alan Walker & Au/Ra - "Somebody Like U"
Alok, Ella Eyre & Kenny Dope - "Deep Down"
Ana Mena & Belinda - "LAS 12"
Babyface - "Keeps On Fallin’" ft. Ella Mai
Bad Gyal - "Tremendo Culón"
BIG30 - "Dead Guyz"
Black Eyed Peas, Shakira & David Guetta - "DON'T YOU WORRY"
BROCKHAMPTON - "Hollywood Swinging"
Bryant Myers - "Guarida"
Bryce Vine - "Nobody"
Chance the Rapper - "The Highs & the Lows " ft. Joey Bada$$
Chlöe - "Surprise"
Chris Brown - "Call Me Every Day" ft. Wizkid
DDG - "Stay In My Circle"
deadmau5 - "XYZ"
Derivakat & Yuki - "Unravel (From "Tokyo Ghoul" - Acoustic Version)"
Diddy & Bryson Tiller - "Gotta Move On"
DJ Frass & Stefflon Don - "Sweet Bounce"
ELHAE - "Know"
Eli Sostre - "Lonely Highway" ft. johan lenox
Escarlata - "Donde Nadie"
Flo Milli - "Conceited"
French Montana & Harry Fraud - "Blue Chills"
French Montana, Harry Fraud & Rick Ross - "Kind of Girl"
Headie One & Luciano - "Cloud"
Hitmaka, Fabolous & Jeremih - "Down Bad"
Horrid1, Sav’O & Black Haze - "Trinibad (GMFT)"
Icona Pop & Ultra Naté - "You're Free"
​iLoveMakonnen & YoungBoy Never Broke Again - "ALL MY SHIT IS STUPID"
INNA - "Magical Love"
Jarom Su'a, Seven Kayne & Vibarco - "EN CARTAGENA" ft. Maia Reficco
JAY1 - "Mercedes"
JELEEL! & Mike Dimes - "CLUBHOUSE!"
JELEEL! - "UNCIVILIZED! (GO!)"
John Legend - "Honey" ft. Muni Long
KALENN - "En tu lado de mi cama"
Kay Flock - "Make A Movie" ft. Fivio Foreign
Kidd Keo - "Wannabes"
Kota the Friend - "FATHER'S DAY"
LAYA - "Sock It 2 Me"
Leon Bridges & Kevin Kaarl - "Summer Moon"
Lil Baby & 42 Dugg - "U-Digg" ft. Veeze
LION BABE - "Yaya" ft. bbymutha
Luke Combs - "The Kind of Love We Make"
Lul Bob - 'Outside"
Måneskin - "If I Can Dream"
MAR MEJÍA - "Nascar"
MØ - "True Romance"
Natti Natasha, Daddy Yankee & Wisin & Yandel - "Mayor Que Usted"
Ne-Yo - "You Got The Body"
Nova Miller - "venus"
PGF Nuk - "Pass The Ball"
Pollari - "4AM in Agoura (Remix)" ft. Tony Shhnow
REASON & Jay Rock - "Is What It Is"
Rico Nasty - "BLACK PUNK"
Rocco Hunt, Elettra Lamborghini & Lola Indigo - "Caramello"
Sam Fischer - "All My Loving"
Samantha Jade - "Dance Again"
SBTRKT - "BODMIN MOOR"
Selfmxdebless - "HeartsCold"
​sevensevenseven & Chief Keef - "​make me mad"
ShaboozeY - "GAS!"
Skibs - "Back N Forth"
Skott - "Evergreen"
SleazyWorld Go & Offset - "Step 1"
Stepz - "Cramp Dat"
Tom Walker - "Number 10"
Tory Lanez - "City Boy Summer"
Wendigo - "The Dark Army" ft. Quadie Diesel, ize & Matt Ox
Vaishalini - "Don't Say I Didn't Warn You"
VIZE, Abraham Mateo & Sofía Martín - "Yo Por Ti"
吳青峰 (Wu Qing Feng) & AURORA - "Storm"
Xavier Omär - "Tarantino"
YNW BSlime - "Pocket Watching"
Yoza - "Fine By Me"
6/19
Ramz - "Best Service"
6/20
Aitch & Bakar - "In Disguise"
boy pablo - "Don't You Want Me" ft. Celine Autumn
黃明德 (Dark Wong) - "沒有穿校服的日子 (Old School)"
DIRTYBUTT - "mama said dont cry 2 / long live borne"
KirbLaGoop & Bleachdiego - "Kop Wit Ease"
NateWantsToBattle - "With You" ft. DAGames
Nedarb & Wicca Phase Springs Eternal - "‍‍i’ll be the fire"
Soulja Boy - "Baseball"
6/21
Alex G - "Runner"
Beyoncé - "BREAK MY SOUL"
Bill Wurtz - "​the ground plane"
Blessd & Rels B - "Energía"
BlueBucksClan - "Just Hit Me"
Ciara - "Treat"
Dayglow - "Then It All Goes Away"
El Alfa - "Chu Chu Pamela"
Icewear Vezzo, Peezy & Payroll Giovanni - "The Commission"
JayDaYoungan - "First Day Out Pt2 (Influential Freestyle)"
Lady A - "Summer State Of Mind"
Oliver Malcolm - "Baby Don't Go"
Stella Donnelly - "Flood"
The Game - "Violence"
The Snuts - "The Rodeo"
Tove Lo - "True Romance"
Zacari & Isaiah Rashad - "Bliss"
6/22
Acid Souljah - "Cheezlworld Ceo"
Ashe - "Angry Woman"
COBRAH - "BRAND NEW BITCH"
Dee Watkins - "For The Birds"
Djo - "Change"
Eli Fross - "Free 1031"
First Aid Kit - "Angel"
Gorillaz - "Cracker Island" ft. Thundercat
Harry Hudson - "A song I wrote after therapy"
Kacey Musgraves - "Can't Help Falling in Love"
​koi - "8 days a week"
L-Gante, DT.Bilardo & Al Records - "MI WOMAN"
Lali - "N5"
LATENIGHTJIGGY - "Nela"
古巨基 & 呂爵安 (Leo Ku & Edan Lui) - "飄流教室 (Floating Classroom)"
Lil Durk - "Did Shit To Me" ft. Doodie Lo
Marian Hill - "back in time"
Matt Ox - "GET OUT MY WAY!"
​Mura Masa, Channel Tres & Shygirl - "hollaback bitch"
Netsky & Rita Ora - "Barricades"
Paolo Nutini - "Acid Eyes"
Paolo Nutini - "Petrified In Love"
Pure Shores - "Light of My Life"
sophie meiers - "untangle me"
Tai Verdes - "sheluvme"
TR/ST - "The Shore"
Zac Brown Band & Blake Shelton - "Out In The Middle"
6/23
A1 x J1 & Mabel - "Deal Or No Deal"
Ambar Lucid - "La Torre"
Arkells, Cœur de Pirate & Aly & AJ - "Dance With You"
BFB Da Packman - "Megan Knees"
Casper Mágico - "De Rumba"
Chris Brown - "Psychic" ft. Jack Harlow
CNCO - "No Apagues la Luz"
DDG - "Making The Band"
Duki - "Celosa"
Eix, Beéle & Maffio - "Cuando Te Veo"
Greyson Chance - "Palladium"
Ingratax & Banda MS de Sergio Lizárraga - "Un Chingazo"
Ingrid Laien & Los Del Fino - "Déjame Revisarte el Celular 2"
James Vincent McMorrow - "Heads Look Like Drums"
Justin Quiles & Robin Schulz - "AEIOU"
La Ross Maria & Ghetto Kids - "Calentón"
Lefty Sm - "Confundido"
merci, mercy - "Black Cloud"
NEEDTOBREATHE - "Talk of the Town"
Noah Cyrus - "Ready To Go"
Not3s - "Where You Been?"
​renforshort - "i miss myself"
Sam Hunt - "Water Under The Bridge"
Sylvan Esso - "Your Reality"
The Interrupters - "Jailbird"
Tony Shhnow - "‎real runtz"
Tyson Yoshi - "if i die tonight"
Yandel, Maluma & Eladio Carrión - "Nunca Y Pico"
6/24
Aaron Cole - "Choose You"
Aidan Bissett - "Twenty Something"
Alexander 23 - "Somebody's Nobody"
Amanda Tenfjord - "All In"
​anders - "Come With Me"
Andy & Lucas - "Son de Amores (Remix)" ft. Abraham Mateo & Lérica
Andy Grammer - "Good Man (First Love)"
Arizona Zervas - "ON TEN"
ASHA - "Fille d'Afrique"
Ashley Kutcher - "Emotionless"
Avery Lynch - "I’m Sorry If I Hurt U Sometimes"
Ayzha Nyree - "Woke Up Like This"
bbno$ & Diplo - "pogo"
Big Yavo - "OVO"
BKTHERULA & Ski Mask the Slump God - "THROUGH 2 U (Remix)"
​carolesdaughter - "xo hope u die"
Charlie Puth - "Left and Right" ft. Jung Kook (정국)
Chayanne - "Te Amo y Punto"
Christina Perri - "home"
Christine and the Queens - "Je te vois enfin"
Chxrry22 - "Call Me"
Citizen Queen - "XO"
Coi Leray - "Involved"
Cuco & Bratty - "Fin Del Mundo"
DaBaby & Davido - "SHOWING OFF HER BODY"
Dave - "My 24th Birthday"
Dess Dior - "Rich and Raw"
Dimitri Vegas, David Guetta & Nicole Scherzinger - "The Drop" ft. Azteck
DMX - "Know What I Am"
Dot Da Genius - "Talk About Me" ft. Kid Cudi, Denzel Curry & JID
Dougie B - "Uzi"
Dove Cameron - "Breakfast"
Echosmith - "Hang Around"
Edurne & NIA - "Te Quedaste Solo"
Elle King & Nile Rodgers - "Honky Tonk Disco Nights"
Elley Duhé - "PIECES"
Eminem & Snoop Dogg - "From The D 2 The LBC"
FLETCHER - "Her Body Is Bible"
Fly By Midnight - "Dance"
GASHI - "Gasoline"
glaive - "minnesota is a place that exists"
G Perico - "Westside Connection" ft. J. Stone
H.E.R. - "Dance To The Music"
Hayley Kiyoko - "deep in the woods"
Huey Mack - "My Favorite"
ILIRA - "Another Heart"
Imagine Dragons - "Sharks"
Jake Miller - "8 Tattoos"
James Bay - "Everybody Needs Someone"
Jaz Karis - "OPTION"
Jenn Morel - "Estilo Cochino"
Jessie Reyez - "FRAUD"
Jonathan Young & Caleb Hyles - "Wolf Within"
Josie Man - "no one cares"
Kalan.FrFr. - "No Stoppin" ft. Blxst
KIRBY - "New D"
LARRENWONG - "Deacon"
Leah Kate - "Twinkle Twinkle Little Bitch"
Lena - "Looking For Love"
Lexie Carroll - "​if i built my home from paper"
Lil Nas X & YoungBoy Never Broke Again - "Late To Da Party"
Lolo Zouaï - "Blur"
​lovelytheband - "sail away"
Mads Langer - "Double Trouble"
Matt Maeson - "A Memory Away"
Meghan Trainor - "Bad For Me" ft. Teddy Swims
Mina Okabe - "Waiting Is A Waste"
Ms Banks - "Bounce"
Nessa Barrett - "die first"
Nightly - "On Your Sleeve"
Peach Tree Rascals - "Let U Go"
Phora - "Fake Smiles 3"
ROA - "JETSKI"
ROSIE - "Something I Hate"
Russ - "Yes Sir"
Sam Creighton - "Heaven From LA"
Sam Feldt & salem ilese - "Hate Me"
Serrini - "樹木真美 (​kiki mami)"
Skibs - "Blue Ferrari"
Sophie Cates - "Nasty"
Taylor Swift - "Carolina"
Tedashii, Trip Lee & Lecrae - "Respect My Team"
The Kooks - "Cold Heart"
Thouxanbanfauni - "Hell Shot" ft. Robb Bank$
Tommy Genesis & Charlie Heat - "all the bands"
Totoy El Frio - "El Cielo"
Tyler Hubbard - "35's"
VEDO & OG Parker - "Face Down"
WILLOW - "˂maybe˃ it's my fault"
Wiz Khalifa - "Bad Ass Bitches"
Young Devyn - "Decisions"
YG, Tyga & 21 Savage - "Run" ft. BIA
Zella Day - "Radio Silence"
ZieZie - "Make a Wish"
6/25
​wolfacejoeyy - "​shake it"
6/26
BABYXSOSA - "FACETIME / TEXTING"
BFB Da Packman - "Stained Couch"
DAGames - "Blue: SSD"
Skeng - "Simple Dutt"
6/27
Jae Stephens - "What's a Monday"
Melvoni - "Trust Issues"
Nadia Rose - "Lyrical Assassin"
Pale Waves - "Jealousy"
per se - "閃念 (The Spark)"
Rina Sawayama - "Catch Me In The Air"
Young King Slaton - "Dance On The Floor"
6/28
Dave East - "How We Livin'"
Fancy Hagood - "Blue Dream Baby" ft. Kacey Musgraves
Lauv - "Kids Are Born Stars"
Lil Gotit - "MF TRIMM"
MAR MEJÍA - "Así Somos"
Sampa the Great - "Never Forget" ft. Tio Nason, Mwanje & Chef 187
Superorganism - "Into the Sun" ft. Pi Ja Ma, Stephen Malkmus & 星野源 (Gen Hoshino)
林家謙 (Terence Lam) - "夏之風物詩 (Summer)"
Yeat - "Rich Minion"
6/29
Aaron Smith - "You"
Anitta & Luck Muzik - "TROPA"
Anna of the North - "Dandelion"
Blue - "Dance With Me"
Claire Rosinkranz - "i'm too pretty for this"
Daya - "Love You When You're Gone"
Derivakat & Yuki - "Glassy Sky (From "Tokyo Ghoul")"
Dermot Kennedy - "Dreamer"
Emotional Oranges - "Make Me Wanna"
Enchanting - "What I Want" ft. Jacquees
FEYZAL - "No Attachments"
Gia Woods - "Lesbionic"
Gryffin & MØ - "Reckless"
Gucci Mane - "All Dz Chainz" ft. Lil Baby
iayze - "Cracked (I'm Him 2)"
JBee & CRYSTAL MILLZ - "Changed"
Kailee Morgue - "Trainwreck"
Kidd Kenn - "Want Not A Need" ft. Baby Tate
Lloyd Banks & Conway the Machine - "Menace"
Mabel - "Let Love Go" ft. Lil Tecca
Maya Hawke - "Thérèse"
Men I Trust - "Hard To Let Go"
Oscar Lang & Wallice - "I've Never Been To LA"
Paulo Londra - "Nublado"
Paulo Londra - "Luces"
RÊVE - "Tongue"
Steve Lacy - "Bad Habit"
Tayla Parx - "Flowers"
YUNGBLUD - "Don't Feel Like Feeling Sad Today"
6/30
Austin Meade - "Red Roof Estates"
B Young - "Ocean" ft. BNXN fka Buju
Big Time Rush - "Honey"
daine - "​sleepwalking"
Dreamer Boy - "HUES"
ECKO, Kaleb Di Masi & Omar Varela - "PÉGATE (RKT Remix)" ft. Lautaro DDJ, Alejo Isakk & Salastkbron
El Osito Wito, Kaleb Di Masi & Mesita - "Coqueta (Remix)" ft. Salastkbron, Alejo Isakk, Roldan Emi & Rodrii Ortiz
Flo Rida - "What a Night"
Freddie Dredd - "Greed"
謝安琪 (Kay Tse) - "憶年 (Life Just Goes On)"
Headie One & Frenna - "Bigger Than Life"
J Balvin & Ryan Castro - "Nivel De Perreo"
Levi Hummon - "Good Riddance" ft. Filmore & YA’BOYZ
Matilda Mann - "Hell"
Miriam Rodríguez - "La Última Función"
吳林峰 (Ng Lam Fung) - "土撥鼠之日 (Groundhog Day)"
RAYE - "Hard Out Here"
Sad Frosty & Chief Keef - "GENGAR"
Sael & Emilia - "Q-Lito"
Seven Kayne & Diablo - "NO SÉ XQ"
Stay Flee Get Lizzy, Lancey Foux & SL - "Simple"
Steff - "La Puerta"
T3 - "A Pleasure"
Tiësto & Charli XCX - "Hot In It"
Young Cister - "LA TERAPIA"
Zachary Knowles - "CIGARETTES"
顧定軒 (Zeno Koo) - "XY"
Zion & Lennox & María Becerra - "Berlín"Embed