3 ContributorsNew Music Friday 02/01/19 LyricsBillie Eilish - bury a friend
Lil Peep - I've Been Waiting (w/ ILoveMakonnen & Fall Out Boy)
Gunna - One Call
Alec Benjamin - Stan - Recorded at Spotify Studios NYC
YBN Cordae - Locationships
AJR - 100 Bad Days
Lil Pump - Racks on Racks
Bhad Bhabie - Bestie (feat. Kodak Black)
BETWEEN FRIENDS - affection
Ally Brooke - Low Key (feat. Tyga)
Ben Platt - Bad Habit
Ty James - Splash
Ariana Grande - 7 rings (feat. 2 Chainz) - Remix
Galantis - Bones (feat. OneRepublic)
Quinn XCII - Life Must Go On
Chantel Jeffries - Facts (feat. YG, Rich The Kid & BIA)
Joyner Lucas - Just Let Go
Omar Apollo - Trouble
Wallows - Are You Bored Yet? (feat. Clairo)
Wiz Khalifa - Alright (feat. Trippie Redd & Preme)
Nina Nesbitt - Is It Really Me You're Missing?
Big Wild - 6's to 9's (feat. Rationale)
Mallrat - Nobody's Home
Beirut - When I Die
Lil Skies - Name in the Sand
Kevin Gates - Right Game Wrong N****
grandson - Apologize
Florida Georgia Line - Women
Big Boi - Doin' It (feat. Sleepy Brown)
Prince Fox - Five Months Later
Cairo Gold - Lie
Snakehips - Gucci Rock N Rolla (feat. Rivers Cuomo & KYLE)
Aaron May - Let Go
JUMEX - LONER
Emily King - Go Back
Cautious Clay - HONEST ENOUGH
Koryn Hawthorne - Unstoppable (feat. Lecrae)
Lexie Liu - Love and Run
Kelsy Karter - Harry
Broods - Too Proud
Chris Burton - Love Letters
Cassadee Pope - Distracted
Empire of the Sun - Chrysalis
IDER - Brown Sugar
Polo G - Pop Out (feat. Lil TJay)
Luis Fonsi - Apaga La Luz
ALMA - When I Die
flora cash - They Own This Town
Astrid S - Someone New
Don Diablo - You're Not Alone (feat. Kiiara)
Cage The Elephant - Ready To Let Go
Theophilus London - Whiplash (feat. Tame Impala)
DROELOE - Only Be Me
Lostboycrow - Suburban Girl
Shift K3Y - Rhythm Of The Drum
Empress Of - When I'm With Him - Perfume Genius Cover
24hrs - My Valentine
JAG - Gucci (feat. $tupid Young)
G Herbo - Never Scared (feat. Juice WRLD)
Interpol - Fine Mess
American Authors - Calm Me Down
Ozuna - Cama Vacia
Matt Simons - Open Up
LÃ‰ON - You And I
EMAN8 - Inspired
Eric Bellinger - Apple Berry Nana
Ady Suleiman - Strange Roses
K CAMP - Writing on the Wall
The Score - Dreamin (with blackbear)
The Dead Tongues - Road to Heaven
Andrew Bird - Sisyphus
OWEL - No Parachutes
Foreign Air - Wake Me Up
Lemaitre - Fast Lovers
Stella Donnelly - Old Man
Demob Happy - Less Is More
Rico Nasty - Roof
Crystal Rome - Morning
Jarryd James - Slow Motion
Berner - Froze Up (feat. SOB X RBE)
joan - drive all night
Bear's Den - Fuel On The Fire
Reignwolf - Black and Red
Girlpool - Pretty
MASHI - Opposite
Yung Lean - Creep Creeps
Brett Young - Not Over You - Recorded at Sound Stage Studios Nashville
George Strait - God And Country Music
Set It Off - Stitch Me Up
Sheppard - On My Way
E.B. The Younger - When the Time Comes
Carlos Sadness - Isla Morenita
Xuitcasecity - Lead Me On
Zeina - In My Head
Sasha Lillie - Better
Bahjat - What We Were
Cavetown - AdviceEmbed