1 ContributorNew Music Friday 7/9/21 LyricsBTS - Permission to Dance
Post Malone - Motley Crew
Billie Eilish - NDA
The Kid LAROI - Stay (with Justin Bieber)
Maluma - Sobrio
BIA - WHOLE LOTTA MONEY (feat. Nicki Minaj) - Remix
Kane Brown - Memory
Jungle - Romeo (feat. Bas)
Yung Bleu - Way More Close (Stuck In A Box) (feat. Big Sean)
Nathy Peluso - MAFIOSA
Zoe Wees - you broke me first - Spotify Singles
Omar Apollo - Go Away
Bad Bunny - De Museo
Vince Staples - ARE YOU WITH THAT?
Snoh Aalegra - NEON PEACH feat. Tyler, The Creator
Jennifer Lopez - Cambia el Paso
John Legend - Crowd Go Crazy
IDK - Keto
Bas - ThĞµ Jackie (with J. Cole & Lil Tjay)
Masked Wolf - Say So
glaivĞµ - fuck this town
Claire Rosinkranz - Hotel
AURORA - Cure For Me
Tkay Maidza - Onto Me (with UMI)
Dave - Clash (feat. Stormzy)
carolesdaughter - please put me in a medically induced coma
Camylio - love and hate
Joy Oladokun - judas
Ant Clemons - Section (feat. Kehlani)
Logic - Get Up
Little Simz - I Love You, I Hate You
Peggy Gou - I Go - Edit
Icona Pop - Off Of My Mind
Tinashe - Bouncin
Nina Nesbitt - Summer Fling
Walk Off the Earth - Love You Right ğŸ•’
Parmalee - Take My Name
Jon Langston - Try Missing You
Sufjan Stevens - Reach Out
Charlotte Day Wilson - I Can Only Whisper (feat. BADBADNOTGOOD)
mazie - dumb dumb
Fredo Bang - Bless His Soul (with Polo G)
Kid Ink - Party
Dro Kenji - CROSS
Jayson Cash - Priority (feat. Blxst)
Amorphous - The Vibe
Frank Walker - Shadows ğŸ•’
Lost Kings - Me Myself & Adderall
Twin Shadow - Is There Any Love ğŸ•’
Inhaler - In My Sleep
Nothing But Thieves - Miracle, Baby
Sam Fender - Seventeen Going Under - Edit
Allison Ponthier - Hell Is A Crowded Room
Courtney Barnett - Rae Street
Oslo Ibrahim - Baby Don't Let Me Go
O.T. Genasis - What Is Your Name ğŸ•’
NGeeYL - Off-White (feat. Lil Uzi Vert)
Cyn Santana - Come
Jam & Lewis - Do It Yourself ğŸ•’
Mariah the Scientist - Walked In (feat. Young Thug)
Montell Fish - Talk 2 Me
Arden Jones - rollercoaster
Frances Forever - daytime ğŸš
Loren Gray - Piece of Work
Conor Maynard - Ain't Got No Friends
Loud Luxury - Wasted ğŸ•’
The Maine - High Forever
POORSTACY - Children of The Dark
Oscar Lang - Thank You
ë°•í˜œì§„ Park Hye Jin - Letâ€™s Sing Letâ€™s Dance
Amen Dunes - Feel Nothing
Tom Odell - over you yet
HONNE - NOW I'M ALONE (feat. SofÃ­a ValdÃ©s)
Naliya - Roller Coaster
Brynn Elliott - Can I Be Real?
Emily Weisband - butterfly (feat. Karen Fairchild)
Charley Crockett - I Need Your Love
Hillsong UNITED - Know You Will
Dwn2earth - Don't Play With Me
Bantu - Unforgivable
Issam Alnajjar - Mn Gheirik Enti
Hotboy Wes - My Lil Dance (feat. Gucci Mane)
Amindi - nwts
GRiZ - Rainbow Brain
EVAN GIIA - In Motion (feat. Reo Cragun) ğŸ•’
Bahari - Forget You
44phantom - problems ğŸ•’
Dylan Cartlidge - Dare To Dream ğŸš
almost monday - til the end of time
LP - Goodbye
Declan McKenna - My House
Spencer. - Lonely As I Ever Was
TAELA - drugs with you
marcos g - 17 anymore
payton - DRIVE AWAY
Rejjie Snow - Shooting Star ğŸ•’
Youssou N'Dour - Raise Your Hand
Jucee Froot - I Need A Bag
Childish Major - F Yah Job
Nicki Nicole - Me Has DejadoEmbed