3 ContributorsNew Music Friday 04/06/18 LyricsBand of Horses - No One's Gonna Love You (Stockholm Version)
Drake - Nice For What
Cardi B - I Do feat. SZA
Calvin Harris & Dua Lipa - One Kiss
A$AP Rocky - A$AP Forever feat. Moby
Alice Merton - Lash Out
John Legend - A Good Night feat. BloodPop®
Shallou - Vignette
ODIE - Story
Lil Xan - Moonlight feat. Charli XCX
Thirty Seconds To Mars - Love Is Madness feat. Halsey
Bear Hands - Back Seat Driver (Spirit Guide)
Slim Jxmmi, Swae Lee & Rae Sremmurd - Chanel feat. Pharrell
Cardi B, Bad Bunny & J Balvin - I Like It
BTS - Don't Leave Me
Sabrina Claudio - Don't Let Me Down feat. Khalid
A-Trak & YehMe2 - Prayer Hands
Joyner Lucas - Frozen
Diplo - Suicidal feat. Desiigner
Belly - Maintain feat. NAV
Tove Styrke - On the Low
Snakehips - Cruzin' feat. St Rulez
Poo Bear - Hard 2 Face Reality feat. Justin Bieber & Jay Electronica
Cuco - CR-V
Famous Dex - CHAMPION feat. Diplo
Rich Brian - watch out!
THEY. - Thrive
Bullet For My Valentine - Over It
Honors - Betterman
Seeb - Drink About feat. Dagny
CNCO - Sólo Yo
Matt Simons - We Can Do Better
Chromeo - Must've Been feat. DRAM
Sofi Tukker - Batshit
Soleima - Bulldog
Elton John, P!nk & Logic - Bennie And The Jets (2018 Version)
Kali Uchis - Just A Stranger feat. Steve Lacy
Hatchie - Sugar & Spice
JT Roach - Chapel
Jake Owen - Made For You
Brothers Osborne - Pushing Up Daisies (Love Alive)
Alison Wonderland - Easy
Alina Baraz - I Don't Even Know Why Though
Saba - LOGOUT feat. Chance The Rapper
Yellow Days - The Way Things Change
Ruston Kelly & Kacey Musgraves - To June This Morning
Ben Howard - A Boat To An Island On The Wall
Gallant - Gentleman
Yellow Claw - Villain feat. Valentina
Bearson - Go To Sleep feat. Kailee Morgue
Mansionair - Violet City
Bazzi - Mine (Bazzi vs. Young Bombs Remix)
Nelly - Freaky with You feat. Jacquees
TINI - Princesa feat. Karol G
Jauz & DJ Snake - Gassed Up
Kevin George - Domino Effect
Wiley - Certified feat. Shakka
R3HAB & Noah Neiman - We Do feat. Miranda Glory
Kenny Chesney - Get Along
The Aces - Last One
Jeremy Zucker - all the kids are depressed
Unknown Mortal Orchestra - Everyone Acts Crazy Nowadays
Col3trane - New Chain
Shinedown - THE HUMAN RADIO
Jason Aldean - I'll Wait for You
Phresher - Teamwork feat. Philthy Rich & Derez Deshon
Naaz - Loving Love (Recorded At Spotify Studios NYC)
Shakey Graves - Mansion Door
Mikky Ekko - What's It Like Now
Morgxn - carry the weight
Bobby Sessions - Like Me
Remy Shuck - Stone Behind My Ribs (Ethan C. Davis Remix)
Hillsong Worship - Who You Say I Am (Live)
London Richards - Matrix
Dermot Kennedy - Couldn't Tell
Molly Kate Kestner - Not Over You
Naomi Wild - Howlin
Sinead Harnett - Body
The Wonder Years - The Orange Grove
Rainbow Kitten Surprise - Matchbox
Middle Kids - On My Knees
Jay Pryor - Rich Kid$
Kesha - I Need a Woman to Love
Jack & Jack - Closure
JOHNNYSWIM & Drew Holcomb & The Neighbors - Ring the Bells
Aquilo - Seagull
Aminé - Campfire feat. Injury Reserve
The Brummies - Drive Away feat. Kacey Musgraves
Eagles Of Death Metal - Blinded By The Light
Thunderpussy - Thunderpussy
L.I.F.T - Locked Up
Hein Cooper - Hear My Voice
Chase Atlantic - Numb to the Feeling
Jakob Ogawa - Velvet Light
Tom Misch - Lost In Paris feat. GoldLink
Underoath - Wake Me
Imad Royal & FRND - Love Is Dead
Wye Oak - Symmetry
Tim Halperin - Work for It
WINNER - EVERYDAY
Handsome Ghost - Soft (Acoustic)
OTR - Close feat. Kai Straw
Mars Today - High Stakes1Embed