1 ContributorNew Music Friday 11/20/20 LyricsMonster (Shawn Mendes & Justin Bieber) - Shawn Mendes
Prisoner (feat. Dua Lipa) - Miley Cyrus
Circles - Megan Thee Stallion
Gucci Peacoat - DaBaby
Pain Away (feat. Lil Durk) - Meek Mill
Somebody’s Problem - Morgan Wallen
Life Goes On - BTS
Love Not War (The Tampa Beat) - Jason Derulo
Holding On-  iann dior
Safe With Me (with Audrey Mika) - Gryffin
Polvo - Nicky Jam
Because of You - Future
2020 DRAFT - Sheck Wes
No Flash - Rich The Kid
Pick Up Your Feelings - Jazmine Sullivan
Sending My Love - Spotify Singles - Chloe x Halle
fue mejor - Kali Uchis
Walked Through Hell - Anson Sеabra
My Head & My Heart - Ava Max
chinatown (feat. Brucе Springsteen) - Bleachers
ESTELLA// (feat. Travis Barker) - KennyHoopla
Hot Boy Bling (feat. Jack Harlow & Lil Durk) - French Montana
10 Missed Calls (feat. Pharrell Williams & Jozzy) - Black Coffee
Dying in the Subtlety - Cautious Clay
Hey Boy - Sia
Coke & Mentos - salem ilese
i might like u - Boon
Pray 4 Me (feat. Kanye West) - SAINt JHN
Baby (with J Balvin) - Sfera Ebbasta
Good Advice - khai dreams
Peppers and Onions - Tierra Whack
Superpower - KIRBY
Almighty Black Dollar (feat. Rick Ross) - Jeezy
Move On - Lil Tjay
Regardless - RAYE
The First Time Ever I Saw Your Face - James Blake
Fumari - Peach Tree Rascals
Silver Lining - Hauskey
Momentum - Russ
Finally Rich - Lil Eazzyy
Got It All - Dom Kennedy
nhs - slowthai
Don't Cry - Bugzy Malone
Hitman - Kelly Rowland
It's About Time (feat. Florida Georgia Line) - Russell Dickerson
If You Wanted It Too - Jake Scott
How Do I Feel - Phil Good
the fire in your eyes keeps me warm - Powfu
dnd - glaive
Slow Down - VanJess
Flawed (feat. Gunna) - Wale
Switched Up - Morray
Opia - Savannah Ré
OUCH - Mau y Ricky
False Reactions - Lastlings
Tell Me About You - Kina
love, or the lack thereof - Isaac Dunbar
Famous Friends - Chris Young
System - Tayla Parx
Wanna Be - ROE
Best Rapper in the Fuckin World - GoldLink
Fallen Stars Flying - Original Song From Between The World And Me - Nas
All of That - Key Glock
WILDLINGS - Tobe Nwigwe
snakes x elephants - Fana Hues
Feels Right - Biig Piig
Break a Little - Ayelle
I Feel Amazing - Harry Hudson
Don't Need No Reason - Lee Brice
Fluff - Tank and The Bangas
Ponte Pa' Mi - Justin Quiles
Bad Azz (feat. Mulatto & Benny The Butcher) - Kash Doll
SKATE - BIA
Catch Me - Damien
Donuts (feat. Yung Bae) - kenzie
Leather Jacket - Spencer Barnett
Feel Like Home - Emmanuel Franco
More Than Friends (with HONNE) - BEKA
Faith - MONEYPHONE
2 Cents - IDK
Aura (feat. Kojey Radical) - Rexx Life Raj
Come And Play With Me - From "Promising Young Woman" Soundtrack - DeathbyRomy
Bedroom Floor Feelings (feat. Marc E. Bassy) - Sarah Barrios
Knocking On My Heart - Frawley
Knicks - Cochise
HEY! - Lil Gnar
I Would Give It All - Joel Blackmon
Loner - NERIAH
SALUTE (feat. Big Sean and Fivio Foreign) - Hit-Boy
September 7th - YFN Lucci
Special Occasion - Raheem DeVaughn
NY - Emily Vu
Tomorrow - JORDY
I'm Getting Tired of Me - Kings Elliot
Lot To Give - Marlon Craft
Police Brutality - Hotboii
Me With You - Gabriel Conte
Your Face - Josh Groban
The Clouds - Matilda Cole
Intrasport - King Gizzard & The Lizard WizardEmbed