3 ContributorsNew Music Friday 07/03/20 LyricsPop Smoke - The Woo (feat. 50 Cent & Roddy Ricch)
Kanye West & Travis Scott - Wash Us In The Blood
Ty Dolla $ign - Ego Death (feat. Kanye West, FKA twigs & Skrillex)
LANY - if this is the last time
Ellie Goulding & Lauv - Slow Grenade
A Boogie Wit da Hoodie & Don Q - Flood My Wrist (feat. Lil Uzi Vert)
Gus Dapperton - Post Humorous
Rina Sawayana - Dance In The Dark - Spotify Singles
Russ - Live From The Villa
Pop Smoke - For The Night (feat. Lil Baby & DaBaby)
Tory Lanez & Kevin Gates - Convertible Burt
Joel Corry - Head & Heart (feat. MNEK)
Jason Derulo, Puri & Jhorrmountain - Coño
Glass Animals - Heat Waves
Ayoni - Unmoved (A Black Woman Truth)
Nicky Jam - Desahogo (feat. Carla Morrison)
Disclosure & slowthai - My High (Edit)
Moneybagg Yo - Said Sum
brakence - sauceintherough
Rema - Woman
GASHI, Pink Sweat$ & Njomza - Upset
AJ Tracey & Mabel - West Ten
Yo Gotti - Recession Proof
Gucci Mane - Breasto (feat. Foogiano)
Tom Morello, Shea Diamond, Dan Reynolds & The Bloody Beetroots - Stand Up
Leo Bhanji - White Hills
Amy Allen - Queen of Silver Linings
Old Dominion - Everything to Lose
Sufjan Stevens - America
Max Leone - Malleable
Christine and the Queens - Eyes of a Child
Lous and The Yakuza - Bon acteur
Smoove'L - Turn Left Turn Right
Rapsody, PJ Morton & D Smoke - Afeni (Remix)
Ricky Reed, Terrace Martin & St. Panther - Real Magic
BAYNK & Tei Shi - TESSELLATE
Bow Anderson - Heavy
Clinton Kane - hopeless
lovelytheband - idwgtyp
Willie Nelson - Don't Let the Old Man In
Ingrid Andress - Waste of Lime
Cian Ducrot - hurt so bad
HONNE - la la la that's how it goes
Dirty South - Kiss from God
Zion & Lennox - All Night
Westside Gunn - Jose Canseco (feat. Stove Good Cooks)
Saweetie - Pretty Bitch Freestyle
Shoreline Mafia - Change Ya Life
keshi - more
yaeow - When I'm No Longer Here
Alfie Templeman - Obvious Guy
Polo & Pan - Atrrape-rêve
Seeb & Julie Bergan - Don't You Wanna Play?
Denai Moore - Fake Sorry
Lime Cordiale - Screw Loose
Mike Shinoda - Open Door
K CAMP & RARE Sound - Cry To You
TOKYO'S REVENGE - GOTHAM
Tinie Tempah - Whoppa (feat. Sofia Reyes & Farina)
Sophia Messa - Ice Cream & Cigarettes
Kungs & J Hart - Dopamine
Mitchell Tenpenny - Broken Up
RaeLynn - Me About Me
Chris Young - If That Ain't Good
Stay Over - IDKATL
Tom Gregory - Rather Be You
Maisie Peters - Sad Girl Summer
Spencer. - Maybe
Buddy - Faces (feat. Lucky Daye)
Terrell Hines - Wu Dirt
Jhay Cortez - Dime A Ve
IV Jay - Stay Mad
iamnotshane - What A Perfect Day For Crying
ASHWARYA - PSYCHO HOLE
Slow Magic & Woven in Hiatus - Somewhere
tobi lou - Lingo Starr: RETURN OF THE DRAGON
$NOT - Can You Help Me
ilyTOMMY - Booty
Fontaines D.C. - Televised Mind
Washed Out - Time to Walk Away
Sally Boy - Sally Boy
La Chica - La Serpiente
Norma Jean Martine - Basketball
Elliot Lee - GoodBadUgly
KILLBOY - THAT'S OK I'LL JUST FUCK MYSELF
Quano Rondo - Depression
No Love For The Middle Child - Wasting Time
Cold War Kids - You Already Know
Koe Wetzel - Sundy or Mundy
Billy Currington - Seaside
Emmi Elliot - Innocent
Sky McCreery - If You Leave
Philthy Rich - No Questions (feat. Yella Beezy)
Bktherula - Summer
Charlotte Clark - Disarray
This Is The Kit - This Is What You Did
Royalties Cast & Bonnie McKee - Let Your Hair Down
Maria Becerra - Tú Me Lo Haces Fácil
Lil West - Give It All Up
Teezo Touchdown - Strong FriendEmbed