1 ContributorNew Music Friday Christian 02/14/20 LyricsCrowder - I'm Leaning On You (feat. Riley Clemmons) [Radio Version]
LEDGER - My Arms
Matthew West - Not Today
Terrian - Let Love Lead
Leeland - Way Maker (Single Version)
Jesus Culture - More Than Enough (Live) (feat. Kim Walker-Smith)
Switch - Jump
Micah Tyler - Welcome To The Family
Alive City - High Low
Avalon - Only One
John Mark McMillan - Juggernaut
Tyson Motsenbocker - High Line
Judah Band - Bless His Name (feat. Cierra Cantrell, Darnell)
Futures - Just The Cross
David & Nicole Binion - Faith Sees (Live) (feat. Todd Dulaney)
** Paul Baloche - Heaven Is Where You Are (feat. Chris Brown)
** Keith & Kristyn Getty - His Mercy Is More (Live) (feat. Matt Boswell, Matt Papa)
Shane & Shane - Praise to the Lord (Joyful, Joyful) (Acoustic)
Mahalia Buchanan - You Fight for Me
David Dunn - Interruption
Vin Bogart - Change Up
Byron Juane - M.I.A (feat. Aaron Cole)
International Show - Undivided
Seph Schlueter - No Distance // Emmanuel
Harper Still - Show Love (feat. Jamie Grace, Morgan Harper Nichols)
Evie Clair - Crossroads
Saint Esprit - Love’s All We Need
Switch - Count Me In
RICHLIN - Royal Blood
Vertical Worship - Not Done Yet
Jason Ingram - Glorious Day (feat. Essential Worship)
Love & The Outcome - Moving On
Leanna Crawford - Funeral
Hope Darst - Peace Be Still
SEU Worship - Here and Now
Bethel Music - God of Revival (Live) (feat. Brian Johnson, Jenn Johnson)
Vineyard Worship - God of Rest (Dios Del Descanso) (feat. Tina Colón Williams)
** Keith & Kristyn Getty - My Savior's Love (What Tongue Could Tell) (Live) (feat. Matt Papa)
Todd Dulaney - Psalms 18 (I Will Call On The Name)
Social Club Misfits - Enough (MOOD Remix) (feat. Austin French, Asher Postman)
WYLD - Your Heart Fit Right In Mine
Jon Guerra - Kingdom of God
John Tibbs - Runaway
planetboom - Unshakeable
Rhyan LaMarr - The Remedy (feat. Jonathan McReynolds, Jack Red)
JJ Heller - Not Enough
The Crabb Family - Stones
Rend Collective - SING IT FROM THE SHACKLES
We Are Messengers - Come See (Glory Hallelujah)
Matt Redman - All Praise (Sing Praise) (Live)
Matthew West - Grace Upon Grace
Red Rocks Worship - Breakthrough (Live)
Thrive Worship - A Thousand More
Roy Tosh - When I'm Gone
** Lion of Judah - Open My Eyes
Mali Music - Let Go
Jon Reddick - Glory and Majesty
Rachael Nemiroff - Draw Me Near
Yung Sum - Late Goodbyes
Spencer Annis - To Know You
Tyson Motsenbocker - Come to California
ØM-53 - Runaways
The Union Chattanooga - Forever Amen (feat. Drakeford)
David & Nicole Binion - Waterfall (Live) (feat. Maranda Curtis)
Q Parker - Made For (feat. Deitrick Haddon, Avery Wilson, Eric Dawkins)
29:11 Worship - For Everyone
CRC Music - Made Whole
Highpoint Worship - Heaven Power
Shaylee Simeone - Dearly Loved (Live Acoustic Version)
Mercy Hill Worship - Your Glory
Cherry Wee - So Amazing (feat. Aisea Taimani + Minor Islands)
Amy Sullivan - Questions (Julie Lov Remix)
Faith Rose - Psalm 32
** InSalvation - Await
J-Phish & Rapzilla - Smoke (feat. Byron Juane)Embed Way Maker - Single Version Way Maker Leeland world-music