2 ContributorsNew Music Friday 11/01/19 LyricsDua Lipa - Don't Start Now
Ariana Grande - Bad To You (with Normani & Nicki Minaj)
NLE Choppa - Forever
Tame Impala - It Might Be Time
HAIM - Now I'm In It
Trippie Redd - Love Me More
Sam Smith - I Feel Love
Martin Garrix - Used To Love (with Dean Lewis)
Chelsea Cutler - Lucky
Miranda Lambert - Track Record
Ariana Grande - Nobody (with Chaka Khan)
21 Savage - Immortal
Pink Sweat$ - I Wanna Be Yours
Skye - VOICES (feat. XXXTENTACION)
Audrey MiKa - Fake Heartbreak
Noah Cyrus - fuckyounoah (feat. London On Da Track)
GASHI - Mr. Ferrari
Lil Peep - When I Lie
Boy In Space - On A Prayer (feat. SHY Martin)
Phil Good - Do You Ever?
Dove Cameron - So Good
Kane Brown - For My Daughter
bbno$ - shining on my ex
X Lovers - Sweatshirt
Earl Sweatshirt - MTOMB
dvsn - No Cryin (feat. Future)
Bea Miller - THAT BITCH
BENEE - Monsta
Miguel - Funeral
Teyana Taylor - Morning
Nicky Jam - Whine Up
Smokepurpp - Stevie
Sheck Wes - YKTS
Dijon - CRYBABY :*()
ALMA - Worst Behavior
Tom Walker - Heartbeats
Lennon Stella - Kissing Other People
UMI - Breathe
Goody Grace - Scumbag (feat. blink-182)
Highly Suspect - Freakstreet
MAX - Checklist (feat. Chromeo)
Labrinth - Where The Wild Things
Sigala - We Got Love
Timmy Trumpet - Therapy
The Script - Something Unreal
Felly - Heartstrings (feat. Santana)
Vince Staples - Sheet Music (Episode 02)
Rod Wave - Sky Priority
Michael Kiwanuka - Solid Ground
Sudan Archives - Limitless
Call Me Karizma - We're Just Kids
Bishop Briggs - SOMEONE ELSE
Mike Shinoda - fine
Buddy - Hollyhood (feat. Kent Jamz)
Gang Starr - Hit Man
R.LUM.R - Lies
Juto - FAF
Digital Farm Animals - Gold
Feid - FRESH KERIAS
Sigrid - Home To You
Beach Bunny - Dream Boy
Pinegrove - Phase
maxime. - pneumonia
Lola Young - 6 Feet Under
Rexx Life Raj - Your Way
AJ Tracey - Kiss and Tell
Kid Ink - Rich
VanJess - Cool Off the Rain (feat. Ari Lennox)
La Roux - International Woman of Leisure
Loote - All the Fucking Time
Mokita - colorblind
Peach Pit - Feelin' Low (F*ckboy Blues)
Cavetown - Things That Make It Warm
Omar Apollo - Frío
HoodRich Pablo Juan - Iced Up
Young Dolph - Tric Or Treat
Landon Cube - Carrie
Yung Baby Tate - CAMP
Young Bombs - Better Day (feat. Aloe Blacc)
Kasbo - I Get You
John Lindahl - The Greatest
Yelawolf - Still Ridin'
Half Moon Run - Jello on My Mind
Cold War Kids - Dirt in my Eyes
New Politics - Unstoppable
Yhung T.O. - Be There
DDG - ALMOST
ICECOLDBISHOP - CREEP
Turnover - Still In Motion
Jutes - Side Show
Arrested Youth - Dig
Bear's Den - Only Son of the Falling Snow
Trouble - Ain't My Fault
Coi Leray - Big
JNR WILLIAMS - Us in Major
Hank Compton - Judge Me
Jeff Goldblum & The Mildred Snitzer Orchestra - The Thrill Is Gone / Django (with Miley Cyrus)Embed