2 ContributorsNew Music Friday 02/22/19 LyricsLil Pump - Be Like Me (feat. Lil Wayne)
P!nk - Walk Me Home
Lele Pons - Bloqueo
Gunna - Outstanding
Tyla Yaweh - High Right Now
Maren Morris - The Bones
Kehlani - Feels
Tierra Whack - Only Child
John Mayer - I Guess I Just Feel Like
Martin Garrix - No Sleep (feat. Bonn)
Tom Walker - Not Giving In
bülow - Sweet Little Lies
Spencer - 17
Digital Farm Animals - Lookin' For
Tropkillaz - Bola Rebola
James TW - Suitcase
San Holo - Lead Me Back
Judah & the Lion - pictures (feat. Kacey Musgraves)
James Bay - Peer Pressure (feat. Julia Michaels)
Blueface - Thotiana (feat. Cardi B, YG) [Remix]
Eric Bellinger - Type a Way (feat. Chris Brown & OG Parker)
Eminem - Get You Mad
Dounia - ROYAL
Weezer - High As A Kite
Col3trane - The Fruits
Soulja Boy - Rich N Whippin
grandson - Stigmata
Luke Christopher - WALKIN' HOME
Freddie Gibbs - Flat Tummy Tea
DREAMDNVR - 90's Kid
Rob Thomas - One Less Day (Dying Young)
Lauren Daigle - Don't Dream It's Over - Recorded at Sound Stage Studios Nashville
Badflower - We’re In Love
MØ - Theme Song (I'm Far Away)
Giggs - HOLD UP
Gary Clark Jr. - Low Down Rolling Stone
Diplo - Mira Mira
Higher Brothers - Won't Believe (feat. ScHoolboy Q)
Aldous Harding - The Barrel - Radio Edit
YoungBoy Never Broke Again - Gangsta Fever
Simple Creatures - Strange Love
Lunay - Soltera
Marc Anthony - Tu Vida en la Mía
Jason Derulo - Let's Shut Up and Dance
Bruno Major - Old Fashioned
T-Pain - A Million Times (feat. O.T. Genasis)
Anna Clendening - Bend & Break
Lauren Duski - Runnin' (To You)
Snoh Aalegra - I Want You Around
Travis Thompson - Eyelids
James Morrison - My Love Goes On (feat. Joss Stone)
Ingrid Andress - Lady Like
Brasstracks - Follows
DJ Stadium - Jewelry
Manila Killa - Skin
NGHTMRE - BANG
Adam Lambert - Feel Something
Stanaj - Sweat (When I Think About You)
Petit Biscuit - Wide Awake
Mötley Crüe - The Dirt (Est. 1981) [feat. Machine Gun Kelly]
Lostboycrow - 27 (Sad Signs)
Rhys Lewis - Hold On To Happiness
Wallows - Scrawny
Timeflies - First Time
Grace VanderWaal - Stray
Michael Brun - How About This
Elina - Mirage
Hermitude - Every Day (feat. Hoodlem)
RKCB - Flowers For Vases
DREAMERS - Die Happy
XYLØ - Fireworks
Max Styler - Animal (feat. Elanese)
Circa Waves - Times Won’t Change Me
Sundara Karma - Little Smart Houses
Blithe - Don't Blink
ELHAE - Sanctuary (feat. Big K.R.I.T.)
Doja Cat - Tia Tamera (feat. Rico Nasty)
Sonder - What You Heard
Feed Me - Pumpkin Eyes
Kevin Garrett - Don't Rush
FINNEAS - Claudia
Vistas - Eighteen
O-Town - Hello World (feat. Colton Underwood)
Tiffany Young - Runaway
Local Sound - Never Far
Dan Bremnes - Weakness
COTIS - Blame
Anthony da Costa - Almost Mine
Tash - Loverboy
Uffie - No Regrets
Maximillian - Beautiful Scars
Evan and Eris - Juzz Do It
DJ Megan Ryte - Unsure (feat. Joey Bada$$, Yung Bleu & Arin Ray)
Brianna Mazzola - How Much
Lil Halima - Take Me To Your Planet
Levi Conner - Wasting My Time
Tucker Beathard - Better Than MeEmbed