2 ContributorsNew Music Friday 3/27/20 LyricsDua Lipa - Break My Heart
PARTYNEXTDOOR - BELIEVE IT
Childish Gambino - Time
Pearl Jam - Retrograde
Alainaâ€…Castilloâ€…- just aâ€…boy
5 Seconds of Summer - Wildflower
Kygoâ€…- Like It Is
NAV - Turks (feat. Travis Scott)
The KidâŸLAROIâŸ-âŸAddison Rae
OneRepublic -âŸBetter Days
Dua LipaâŸ- Hallucinate
Trevor Daniel - Lovesick
Hailee Steinfeld - I Love You's
Joyner Lucas - The War (feat. Young Thug)
Tory Lanez - Do The Most
ROSALÃA - Dolerme
Jeremy Zucker - julia
Jessie Reyez - COFFIN (feat. Eminem)
Run The Jewels - Ooh LA LA (feat. Greg Nice & DJ Premier)
Major Lazer - Lay Your Head On Me (feat. Marcus Mumford)
Peach Tree Rascals - Things Won't Go My Way
Oliver Malcolm - Helen
brakence - dropout
Orion Sun - Trying
Little Mix - Break Up Song
Delacey - Black Coffee
Kane Brown - Last Time I Say Sorry
Ingrid Andress - The Stranger
Bright Eyes - Persona Non Grata
Alina Baraz - More Than Enough
Wiz Khalifa - Contact (feat. Tyga)
Murda Beatz - Banana Split (with YNW Melly feat. Lil Durk)
Fivio Foreign - Wetty
Rvssian - Only The Team (with Lil Mosey & Lil Tjay)
GASHI - Never Forget
Sam Feldt - Hold Me Close (feat. Ella Henderson)
Anne-Marie - Her
Florida Georgia Line - I Love My Country
Cavetown - Pyjama Pants
Goth Babe - End Summer
Shallou - Good Together
Kailee Morgue - Knew You
AUSTN - Phases
[SEBASTIAN PAUL - BACK AND FORTH] ğŸš
Comethazine - Permanent
BlocBoy JB - Swervin
[Lourdiz - Suicide Down] ğŸš
Destructo - Bandz (feat. Yo Gotti, Kevin Gates & Denzel Curry)
[Hollaphonic - Save Me] [ğŸš]()

R3HAB - Good Example (with Andy Grammer)
Sebastian Yatra - Falta Amor
Carlie Hanson - Daze Inn
Nea - TG4M - Spotify Studios Recording
Mokita - Take It Back
[Quin Nfn - Static] ğŸš
Jeezy - Poppin'
Joey Trap - I Do
Channel Tres - Weedman
Little Dragon - Where You Belong
keshi - less of you

[Elah Hale - Gentle] ğŸš
[Jenevieve - Baby Powder] [ğŸš]()

Giveon - FAVORITE MISTAKE
Mozzy - I Ainâ€™t Perfect
Lil Loaded - Hit Em Up
Mick Jenkins - Snakes
Thomas Headon - Butterflies
Car Seat Headrest - Martin
Waxahatchee - Witches
Dirty Projectors - Search For Life
[IV Jay - The Hard Way] [ğŸš]()
Trouble - Popped
42 Dugg - Not A Rapper
JAHMED - LIFTMEUP
Nasty C - There They Go
Camilo - Favorito
Loud Luxury - Aftertaste
[Ghita - Out of My Life] ğŸš
Lido - Postclubridehomemusic
UPSAHL - 12345SEX
Moby Rich - Get High
Lunay - La Cama - Remix
KSI - Poppin (feat. Lil Pump & Smokepurpp)
Marlon Craft - Mom's Whiskey (feat. Kota the Friend)
[Nef The Pharaoh - Mackin & Hangin] ğŸš
Trapboy Freddy - Let Me Find Out (feat. Yella Beezy)
24hrs - Superstar
Cameron Dallas - Secrets
Alice Gray - Del Mar
Quinn Lewis - If I Could Dance

[Jeremy Renner - Best Part of Me] ğŸš
[The Glorious Sons - Don't Live Fast] ğŸš
Jack Curley - Tomorrow
Chelsea Collins - Used to be (L.O.V.E.)
Nodis - FEEL SOMETHING
[Trap Manny - One Night Stand] ğŸš
645AR - In Love With A Stripper
Tom Misch - Kyiv
Bob Dylan - Murder Most FoulEmbed