1 ContributorNew Music Friday 10/14/22 LyricsLil Baby - California Breeze
Marshmello - Bye Bye
blink-182 - EDGING
The 1975 - Oh Caroline
Tove Lo - Grapefruit
Lil Yachty - Poland
girl in red - October Passed Me By
Zach Bryan - Starved
Doechii - Stressed
Stormzy - Hide & Seek
MUNA - August - Recorded At Electric Lady Studios
Noah Kahan - Growing Sideways
Bailey Zimmerman - Waiting
Hope Tala - Stayed at the Party
Farruko - Viaje
Pink Sweat$ - Lay Up N Chill (feat. A Boogie Wit da Hoodie)
Nardo Wick - G Nikes (feat. Polo G)
Nessa Barrett - dear god
Jessie Murph - How Could You
Central Cee - One Up
SG Lewis - Call On Me (with Tove Lo)
Fazerdaze - Thick of the Honey
Madison Beer - Showed Me (How I Fell In Love With You)
Ethan Bortnick - arsonists
G Herbo - Him
Alexander 23 - ill (feat. Kenny Beats)
Ashe - omw
Chesca - ACTIVA
Lolo ZouaÃ¯ - Crazy Sexy Dream Girl
SAULT - Angel
Robert Glasper - Therapy pt. 2 [Feat. Mac Miller]
Chief Keef - Racks Stuffed Inna Couch
bbno$ - i see london i see france
JAWNY - wide eyed
niceboy ed - heaven
Tom Walker - The Best Is Yet to Come
Queen - Face It Alone
Bruce Springsteen - Nightshift
2 Chainz - 2 Step
A1 x J1 - Don’t Lie (feat. Nemzzz)
STANY - Only You
M.I.A. - Marigold
JON VINYL - Slowly
Sarah Kang - epilogue
Joshua Bassett - SHE SAID HE SAID SHE SAID
half•alive - Did I Make You Up?
Louis Tomlinson - Out of My System
HARDY - TRUCK BED
Red Hot Chili Peppers - The Drummer
Plains - Hurricane
Michal Leah - The Way I Love You
Lexi Jayde - what's the matter with you
RAYE - Escapism.
Gucci Mane - Gucci Flow (feat. Finesse2tymes)
French Montana - Whipp'n It Slowly
Kx5 - Alive (feat. The Moth & The Flame)
KIRBY - Take Care
Alaina Castillo - fantasies
Laufey - Questions For The Universe
MIA GLADSTONE - OPEN LETTER (feat. Teezo Touchdown)
Waterparks - FUCK ABOUT IT (feat. blackbear)
joan - don't wanna be your friend
Hotel Ugly - The Mannequin Song
Tee Grizzley - Robbery Part 5
MAVI - High John
PawPaw Rod - Lovetap
Mykki Blanco - Carry On
Men I Trust - Girl
Briston Maroney - Oregon
Blake Rose - Dizzy
Callista Clark - Worst Guy Ever
Zella Day - I Don’t Know How To End
Sebastian Mikael - Scene 1
Piso 21 - Felices Perdidos
$NOT - SIMPLE
Xowie Jones - Horror Scene (feat. aldn)
Weyes Blood - Grapevine
nicole han - WANNABE
KiNG MALA - martyr
KenTheMan - Not My N*gga
NERIAH - Fuck You Matthew
Betty Who - BIG
Jon Keith - IGWT
ARTBAT - It's Ours - Short Mix
Grupo Marca Registrada & Luis R Conriquez - Puro Campeón
Jacob Latimore - Selfish
Flwr Chyld - Break Me Down/ Here with You
Miko Marks - This Time
Charlotte Dos Santos - Aria 4 Arien
Liv Miraldi - Wingwoman
Annika Rose - Bruises
Big Boss Vette - Pretty Girls Walk
The Arcs - Keep On Dreamin'
papa mbye - PIXEL
hey, nothing - i haunt ur dreams
Runnner - i only sing about food
Corey Kent - How You Know You Made It
Mikhala Jené - Black Love
auston ghost - KIDS
Fujii Kaze - graceEmbed