1 ContributorNew Music Friday 10/16/20 LyricsLonely (with benny blanco) - Justin Bieber
By Yourself (feat. Jhené Aiko & Mustard) - Ty Dolla $ign
Before - James Blake
lie to me - Tate McRae
Fake - Lauv
Whole Lotta Choppas (Remix) [feat. Nicki Minaj] - Sada Baby
Hate The Way (feat. blackbear) - G-Eazy
Together - beabadoobee
Let Me Love You Like A Woman - Lana Del Rey
Pardon (feat. Lil Baby) - T.I.
Legend - Benny The Butcher
Chasing_(Demo) - NF
¡párate! - Alaina Castillo
In Your Eyes (feat. Kenny G) - Remix - The Weeknd
Meeting (feat. Foogiano & Mulatto) - Gucci Mane
All About You - Leon Bridges
Can't Put It In The Hands Of Fate (feat. Rapsody, Cordae, Chika & Busta Rhymes) - Stevie Wonder
All That (with Channel Tres) - Emotional Oranges
Want U Around (feat. Ruel) - Omar Apollo
No Other Way - SHAED
I’m Okay Though - Sara Kays
Commander In Chief - Demi Lovato
Matter To You - Sasha Sloan
Mean - $NOT
Bankroll - Rich The Kid
Dans la hess - Lous and The Yakuza
Only Time Makes It Human - King Princess
Tequila & Lemonade - merci, mercy
QueLoQue (feat. Paloma Mami) - Major Lazer
You’re Mines Still (feat. Drake) - Yung Bleu
PERSIAN RUGS - PARTYNEXTDOOR
Monique - DaniLeigh
Nature Of The Beast (feat. Portugal. The Man & The Last Artful, Dodgr) - Black Thought
Get It Back - Pearl Jam
Never Get Old - Russell Dickerson
Crazy - Kelly Rowland
Sharpener - Cavetown
Trigger Of Love - JAWNY
Billetes Azules (with J Balvin) - KEVVO
BET Uncut (feat. Chance The Rapper & Smino) - MadeinTYO
Drumdown Mambo (feat. Jasiah) - Whethan
All We Got (feat. KIDDO) - Robin Schulz
Choke - Royal & the Serpent
MURDA - Preme
Love Language - Queen Naija
Diamond Choker - Lil Gnar
Unfold You - Rostam
I Don't Mind - Sturgill Simpson
time online - Nightly
Swing - CXLOE
You - Boon
Change - TSHA
Self Care (with COIN) - Louis The Child
Happiness - Little Mix
Made (feat. Pink Sweat$) - Sophia Messa
Satisfacción - Arcangel
Make A Wish (Birthday Song) - NCT U
Breakin' U Off - Tm88
Solid (feat. 42 Dugg) - Yella Beezy
Show Me What You Got (feat. O.T. Genasis) - Lil Keed
King Alfred - IDK
Can't Let You Go - Stefflon Don
Take Me Away (feat. EARTHGANG) - Sinead Harnett
Airpods - Astrid S
Overwhelmed - Harry Hudson
afterthoughts - renforshort
sippy cup - mazie
Lemon [Feat. Sharon Van Etten] - Local Natives
Who’s Gonna Stop Me (feat. "Weird Al" Yankovic) - Portugal. The Man
Spa - Icona Pop
Never - Young Nudy
Way Too Soft - Melii
Bloodrush - Andrew Broder
Wild Child (with Tom Morello) - The Struts
I Wish I Was A... - NOISY
Silver Springs (Feat. Gail Ann Dorsey) - Matt Berninger
Searching For The Light - VHS Collection
Baddie - Dylan & Dakota
Do It Like Me - Bhad Bhabie
Keep It Moving - Statik Selektah
Keep Your Distance - Ameer Vann
West Coast (feat. Quinn XCII) - DVBBS
Lose You - Jordan Davis
Memory I Don't Mess With - Lee Brice
Help (feat. Rence) - Sarah Barrios
Devil That I Know - Jacob Banks
PSYCHO - from the Crimson Soundtrack - BEAM
Sucio Y Lento - Mariah Angeliq
Would You - The Vamps
Guess I'm a Liar - Sofia Carson
The High - Malia Civetz
Don't Lose Hope - Cochren & Co.
Look at Me Now - Matt Stell
Just Want To Be Loved - Mipso
When It Breaks - Inhaler
Birthday - TyFontaine
Scared - Kembe X
Gold - Claud
Stopped Buying Diamonds - YDE
I Blame You - Paris HiltonEmbed