13 ContributorsMay 2022 Singles Release Calendar Lyrics5/1
Duwap Kaine - "Fuck Court"
Rod Wave - "​sorry 4 the wait"
Sarah Close - "Liars Like You"
5/2
Alison Wonderland - "Something Real"
Aly & AJ - "Like Whoa (A&A Version)"
Black Birdie - "RATED R"
Juicy J & Duke Deuce - "Step Back"
5/3
Bandalos Chinos - "Cállame"
Bizzy Banks - "Don't Know How to Act"
Carlos Vives - "Babel" ft. Fito Páez
CHAI - "SURPRISE"
雲浩影 (Cloud Wan) - "願望之翼 (Wing of Desire)"
Elcamino - "Better Than Love" ft. Curren$y
Hovvdy - "Hide"
Jay Critch - "Sade" ft. Mally Bandz
Kany García & Alejandro Sanz - "Muero"
L-Gante - "Engafado"
Lady Gaga - "Hold My Hand"
Lil Kari - "Who For Me"
Marlon Williams - "My Boy"
Maximus Wel - "Bad Bi$h"
Morelli - "Mala Conmigo"
Porridge Radio - "End of Last Year"
STONEBWOY - "Therapy"
Tove Lo - "No One Dies from Love"
Trueno - "MANIFIESTO FREESTYLE"
Wallice - "Funеral"
YXNG K.A - "Closed Case" ft. B-Lovee
5/4
070 Shake - "Wеb"
Beach Bunny - "Karaoke"
Benji Gramitos & Sayian Jimmy - "Quiere Ma"
Dougie B - "I'm Back"
Emeli Sandé - "Ready to Love"
Everything Everything - "Pizza Boy"
grentperez - "Wishful Thinking"
Jamie T - "The Old Style Raiders"
Javiielo & Nekxum - "Mi Casi Algo"
John C & WE$T DUBAI - "PASTILLAS DE COLORES"
LATENIGHTJIGGY - "Úsame"
Lil Pump - "1ST OFF"
Lozeak - "No Saving You"
Margaret - "Cry In My Gucci"
Noah Davis - "Peaches & Cream"
Pond - "Hang a Cross on Me" ft. Cowboy John
Rapsody - "Dust to Diamonds" ft. Faouzia
Rei & Callejero Fino - "Tu Turrito"
Rolling Blackouts Coastal Fever - "Dive Deep"
Tony Shhnow - "LAST CHANCE" ft. ZelooperZ
Winona Oak - "Jojo"
YN Jay - "Coochie Island" ft. Babyface Ray

5/5
3AM - "Si Caigo"
A$AP Rocky - "D.M.B."
Better Temperatures - "Out of Bounds" ft. BIGBABYGUCCI
Chucky73 - "Freestyle 73"
Cosmo's Midnight - "Bang My Line" ft. Tkay Maidza
Dermot Kennedy - "Something to Someone"
Dylan J - "Before It Started"
EL IMA - "Papi Suena"
Fanny Lu - "Amor de mi vida"
Flor Vigna - "Guión"
Ha*Ash - "Serías Tú"
Headie One - "Came in the Scene"
Hideyoshi - "Shinpainai" ft. AKLO
陳卓賢 (Ian Chan) - "Got U"
Immasoul - "Na Pa Ti" ft. Kofi
J Álvarez & Ñengo Flow - "Química"
Jaguar Jonze - "PUNCHLINE"
Jesse & Joy - "Imagina"
Jon Z - "Joven de la Calle"
Kapo, La Gabi & Nath - "Moka"
Kevin Roldán - "Llanogrande"
Luana & Thyago - "PA' SIEMPRE"
M Huncho - "Who We Are" ft. Yung Bleu
Motherflowers - "Qué Quieres Tú De Mí?"
Mya K - "Tipsy"
NSG & LD - "Roadblock"
Odeal - "Coffee (don't read signs)"
Paula Jivén - "Rude Girl"
Pip Millett - "Downright"
Princesa Alba & Paula Cendejas - "​besitos, cuídate (Remix)"
Sofia Thompson & Sobrino - "Gotas"
Sorana - "Karaoke"
Susana Cala & Bacilos - "Paralizante"
TINI - "La Triple T"
Ventino - "Mariposas"
Willow Kayne - "Final Notice"
Wilmer Roberts - "Fama y Dinero"
Xcelencia - "Isla Verde"
5/6
AJ Tracey - "Reasonable"
Alaina Castillo - "​sad girls always finish first"
American Authors - "Good 4 U"
Amesty & Ovy On The Drums - "Química"
Andy Grammer & R3HAB - "Saved My Life"
Anna Clendening - "Sweatshirt"
Annika Wells - "Stay High"
Anthem Lights - "You Are My Sunshine"
Ashe - "Hope You're Not Happy"
Bad Bunny - "Moscow Mule"
Badda TD - "Moonwalking" ft. Ron Suno & DJ Drama
Belinda - "Eden"
Berre - "Say My Name"
Bishat - "Manners"
Boyce Avenue - "Only Time"
Busy Signal - "Thank You Jah"
Call Me Loop - "Pattern of Behaviour"
Carlo Laquinta - "Plan B"
Carly Rae Jepsen - "Western Wind"
Casero - "Cosas Que Creo"
Chappell Roan - "My Kink is Karma"
Chris Andrew, Wisin & Dreah - "Mató a Cupido (Remix)"
Christian Nodal - "Vivo en el 6"
Christina Perri - "mothers"
Cris Mj, Mendoza & Ghetto Kids - "Webcam"
Crooked Stilo - "Ella Me Da"
Dana Williams - "Bleu"
Derivakat - "Pomegranate Lips"
DIXSON - "CHERRY SORBET" ft. Sevyn Streeter
DNCE - "Move"
Doja Cat - "Vegas"
Dro Kenji - "They Don't Know"
Duke Deuce - "CRUNKSTARZ"
Duncan Lawrence - "Take My Breath Away"
Dylan Fuentes & Sael - "Sonrisa Falsa"
Dylan Scott & Jimmie Allen - "In Our Blood"
EDDISON & Lei - "habit"
Edén Muñoz & Michelle Maciel - "No Sabía Cuánto"
Edith - "Falling Away" ft. Taj Ralph
ELIO - "I LUV MY BRAIN!"
Flowtiago - "Que Dios Me Libre"
Francisca Valenzuela - "Dar y Dar"
Gian Varela & Steve Andreas - "Veneno" ft. Felicia
Gretta Ray - "Vienna"
Gryffin & Calle Lehman - "Alive"
Guitarricadelafuente - "A carta cabal"
Icewear Vezzo - "Sicc Of Y'all"
James Johnston - "COUNTRY BOYS"
JAYLIEN - "Take Me with You"
Jenn Morel - "Sigue y Sigue"
Jeris Johnson - "RAINING BLOOD" ft. ZillaKami
Joel Corry, David Guetta & Bryson Tiller - "What Would You Do? (Alle Farben Remix)"
Jonas Blue, Sam Feldt, Sam DeRosa & Endless Summer - "Till The End"
J. Stone - "Weekend" ft. Young Dolph
Kaio Viana, Bad Gyal & Totoy El Frío - "Formosa (Remix)" ft. MC CJ
Kane Brown - "Like I Love Country"
Kasabian - "SCRIPTVRE"
KayCyy - "Borrow"
KEY! - "Boom"
Kota the Friend - "UP"
Kygo - "Freeze"
Lakeyah - "I Look Good"
​lilbubblegum & Letoa - "chiropractor"
Lil Gnar & Yung Bans - "My Bruddas"
Lil Jon & Ghastly - "Dance"
Lil PJ - "Red Rum"
Lola Indigo - "Spinelli"
Logic - "Therapy Music" ft. Russ
Louie Ray - "Next to A M" ft. Baby Money
Lucas Estrada, Twan Ray & Solar State - "100 Stars"
Lucki - "GOOD MEMORIES"
Maisie Peters - "Cate's Brother"
Meg Myers - "CHILDREN OF LIGHT II"
Métricas Frías, Zor Beats & Doble Porción - "Aviso Parental"
MIA GLADSTONE & Matt Martians - "EMPATHY"
Mili - "GIVE ME RICE"
Mocedades & Morat - "Sobreviviremos"
Morray - "Momma's Love"
Mothica - "LAST CIGARETTE" ft. Au/Ra
Mozzy & Shordie Shordie - "Tell The Truth"
Natalia Lacunza - "Todo Va A Cambiar" ft. Karma C
NGeeYL - "Escalade"
NGeeYL - "Red Light"
Oli Harper & Jason Walker - "Better Nights"
Oliver Heldens - "I Was Made For Lovin' You" ft. House Gospel Choir & Nile Rodgers
OMB Peezy - "Mission"
OmenXIII - "LIVE FAST DIE SLOW" ft. Travis Barker
Pailita & Nio García - "Yo Quiero"
Quelly Woo - "Get Better"
Rae Morris - "Go Dancing" ft. Fryars
Rah Swish - "Tell ’Em"
Río Roma - "Amor Eterno"
Ralphy Dreamz - "Se Me Olvidó Otra Vez"
Rio Da Yung OG - "Cold Hearted" ft. Louie Ray
Robin Schulz & David Guetta - "On Repeat"
Rombai - "Vamo A Tomar Una"
Roy Woods - "Insecure"
S-X & KSI - "Locked Out"
Sabino - "Dime Tú"
陳珊妮 (Sandee Chan) - "罪美 (Beautiful Sin)"
Shy Glizzy - "Borderline" ft. EST Gee
Sin Bandera - "Nadie"
Skott - "Sunshine"
Stunna 4 Vegas - "BMF" ft. Icewear Vezzo
Tayc - "Sans effet"
Taylor Swift - "This Love (Taylor's Version)"
The Snuts - "End of the Road" ft. Rachel Chinouriri
Thouxanbanfauni - "DRASTIC MEASURES" ft. UnoTheActivist
Toosii - "Keeper"
Tove Styrke - "YouYouYou"
Two Friends - "Wish You Were Here"
Tyga - "Sheikh Talk"
Unlike Pluto - "Sorry to Bother You"
The Vamps - "Wake Up (Spanish Version)"
​WESTSIDE BOOGIE - "STUCK"
wolfacejoeyy - "okay!"
Wrabel - "closure"
YEИDRY - "KI-KI"
YoungBoy Never Broke Again - "Don't Rate Me" ft. Quavo
YUNGBLUD & WILLOW - "Memories"
5/8
Jessica Mauboy - "Automatic"
Kai Cenat - "Bustdown Rollie Avalanche" ft. NLE Choppa
Kendrick Lamar - "The Heart Part 5"
5/9
IV JAY - "Good Karma"
Jay Fizzle - "Paper Route Bidness"
Lil Mexico & Slimelife Shawty - "Bad Habits"
Pale Waves - "Lies"
Starcrawler - "Roadkill"
5/10
Alex Dupree - "Fake Diamonds, False Powers"
Amaia & Aitana - "La Canción Que No Quiero Cantarte"
黎展峯 (Andy Lai) - "跳 (Leap)"
Becky G - "BAILÉ CON MI EX"
Bill Wurtz - "if the world doesn't end"
BKTHERULA - "?????"
Chlöe - "Gyalis (Remix)"
DaniLeigh - "Dead to Me"
Joy Oladokun - "Purple Haze"
REASON - "Churchill Downs Freestyle"
Santa Fe Klan - "Eres"
Shygirl - "Firefly"
YGTUT - "Thinkin Bout"
5/11
5 Seconds of Summer - "Me, Myself & I"
Arlie - "​landline"
Big Gigantic, VIC MENSA & Mick Jenkins - "Just the Same"
Chance the Rapper, VIC MENSA & Smoko Ono - "Wraith"
DaBaby - "BONNET" ft. Pooh Shiesty
DaBaby & Moneybagg Yo - "WIG"
Dreezy - "Balance My Lows" ft. Coi Leray
Kabasaki & Mala Rodríguez - "No Vales Na"
Micro TDH, Jerry Di & Big Soto - "EN SOLEDAD" ft. ADSO & Akapellah
Miquela - "Masterpiece"
Nova Twins - "Puzzles"
Rusherking - "Ice Cream"
Wet - "Tell Me Why"
5/12
Abraham Mateo & Ana Mena - "Quiero Decirte"
Alex Rose & Wisin & Yandel - "Sentido"
Ambar Lucid - "GIRL UR SO PRETTY"
Andy Rivera, Ñejo & Ryan Castro - "Monumento (Remix)'
Bazzi - "Will It Ever Feel the Same?"
​bLAck pARty - "Hotline"
Carlos Vives, Black Eyed Peas & Play-N-Skillz - "El Teke Teke"
Cat Burns - "Go (Remix)" ft. Loski & Russ Millions
Chris Lebron, Sech & Jay Wheeler - "Desde Mis Ojos (Remix)"
D-Block Europe - "Black Beatles"
Dende - "Round Trip to Atlanta"
DJ Tao & L-Gante - "L-Gante DJ Tao Turreo Session #10"
Fabbio & Sael - "Que Te Vaya Bien"
Feid - "Castigo"
Frank Louis & Luar La L - "Piénsame"
Funkmaster Flex - "Hitta" ft. Bobby Shmurda
張敬軒 (Hins Cheung) - "賽勒斯的愛 (Cherlas)"
Jan Blakeee, Brytiago & Gønza - "Esquinita"
陳柏宇 (Jason Chan) - "墜落 (Dare to Fall)" ft. Novel Fergus
Juliana - "Toda la Vida"
KG970 - "JALEO"
Lautaro Lopez - "Cuántas Veces"
María José - "Me Quedo Aquí Abajo"
Matt Louis - "To' Los Días"
Melymel & Shadow Blow - "Profundo"
Moffa - "Ninfómanos"
Mont - "ZUKI"
Nath - "Sin Maquillaje"
Post Malone - "Cooped Up" ft. Roddy Ricch
Rc La Sensación - "Papá Dios"
renforshort & Travis Barker - "we'll make this ok"
Selfmxdebless - "HELL'O'LAND"
張蔓莎 (Sabrina Cheung) - "到時見 (Maybe That's the Right Time)" ft. LEWSZ
TDA Papi - "No y Si" ft. Leslie Shaw
Tion Wayne & La Roux - "IFTK"
Trueno - "TIERRA ZANTA"
UMI - "moonlit room"
5/13
Afourteen - "OMNIVORE"
Akim - "Fettuccine"
Ana Mancebo - "sed de ti"
江𤒹生 (Anson Kong) - "信之卷 (Sin No Maki)"
Arin Ray - "Gold"
Armin van Buuren, AVIRA & Chicane - "Offshore"
Belinda - "Colorblind"
BORJA & Valentina Rico - "tensión"
Brett Eldredge - "Wait Up For Me"
Bret McKenzie - "A Little Tune"
Burna Boy - "Last Last"
Clever - "Cup of Tea"
Cris Mj - "Empezamos de 0"
CyHi & Jacquees - "Tears"
Dani Roig - "Stop Talking" ft. Dylan Goldstein & Gaby Diaz
Davido - "Stand Strong" ft. The Samples
Drew Parker - "Little Miss Saturday Night"
EDDISON - "Murda"
Five Finger Death Punch - "IOU"
Fritz Hager - "Hearts Align"
Galantis - "1x1"
Gryffin & Olivia O'Brien - "Caught Up"
ILLENIUM - "Shivering" ft. Spiritbox
Inayah - "Always Something"
Ir Sais & Anselmo Ralph - "Chikita Mala (Remix)"
James Bay - "One Life"
JAY MAX - "Take a Look" ft. Kontra Marín
John Lindahl - "I Think I Did It Again"
Join The Riot - "Betty Love"
Jon Bryant - "This Book"
Josephlee - "Dormitorio"
Juan Vegas & Nicole Favre - "Me Encanta"
Joy Again - "Who Knows"
Juseph & Quevedo - "Yatekomo"
Katia Morales - "Lento"
Kina - "I'll always wait 4 u" ft. Kehard
King Combs & DreamDoll - "Gas You Up"
Lara D - "Better By Myself"
Lera Lynn - "Something More Than Love"
Leven Kali - "EVERYTHING I WANT"
Lil Tracy - "Paranoid"
Loreen - "Neon Lights"
Luclover - "NUMB ENOUGH"
Lunay - "Bandida"
Maffio & ChocQuibTown - "Jaguayuken"
Måneskin - "Supermodel"
Mark Ronson - "Too Much" ft. Lucky Daye
Matt Ox - "Blastoff"
Megami - "Tenerte Aquí"
MIKA - "Yo Yo"
Morgan Wallen - "You Proof"
Muni Long - "Pain"
Nakkia Gold - "Low Profile"
Never Broke Again, YoungBoy Never Broke Again & P Yungin - "Gang Baby" ft. Rojay MLP & RJAE
NextYoungin - "F My X"
Ne-Yo - "Don't Love Me"
NGHTMRE & KLAXX - "The One"
Noah Cyrus - "Mr. Percocet"
Noah Thompson - "One Day Tonight"
NOTD & Kenzie - "Worst Thing"
OneRepublic - "I Ain't Worried"
PmBata - "​i hate her boyfriend's face"
Projexx - "Brace It (Remix)" ft. Konshens
​​remy - "closer to thirty"
Ria Sean - "Thai Food"
Riley Green - "Hell of a Way to Go"
Rita Ora - "Finish Line"
Rosie Darling - "Fucked Up Summer"
Sematary - "BLEED A RIVER"
Shawn Mendes - "When You're Gone (Acoustic)"
Smash Mouth & Owl City - "All Star (Owl City Remix)"
st. Pedro - "En La Cama"
Steve Aoki & Natanael Cano - "Kong 2.0"
Sub Urban - "CANDYMAN"
Tate McRae - "what would you do?"
林家謙 (Terence Lam) - "doodoodoo"
The Aquadolls - "Help (I'm Falling 4u and I Can't Get up)"
Thouxanbanfauni - "SPEND A MINUTE"
Tory Lanez - "Shot Clock Violations"
Trey Lewis - "Whatever She Sees in Me"
Unlike Pluto - "It Goes Inside My Head"
Vory - "Do Not Disturb" ft. Yung Bleu & NAV
Why Don't We - "Just Friends"
X Ambassadors & ROBI - "Palo Santo (Remix)"
yvngxchris - "DAMN HOMIE" ft. Lil Yachty
Zao Elar - "Si Me Pego Mañana"
5/14
Soulja Boy - "Whip It Up"
YoungBoy Never Broke Again - "See Me Now"
5/16
Cazzu - "Jefa"
Ed Sheeran - "2step (Brazilian Remix)" ft. Chefin
張蔓姿 (Gigi Cheung) - "PANDA"
Kevin Gates - "Bad For Me"
Lil Zay Osama - "glah glah"
Moneybagg Yo & Kodak Black - "Rocky Road"
Since99 - "Semi High"
Toosii - "Secrets"
Ty Segall - "Saturday Pt. 2"
5/17
BVDLVD - "LAYIN BRICKS"
Deante' Hitchcock - "All My Children"
Deante' Hitchcock - "Callin'" ft. Big K.R.I.T. & WESTSIDE BOOGIE
Duwap Kaine - "Coolin"
Flume - "Hollow" ft. Emma Louise
Fredo Bang - "Dead Man"
Kamaiyah - "F.W.I." ft. DaBoii
ROBI & Moffa - "Un Momento"
Snoop Dogg - "Touch Away" ft. October London
Thaiboy Digital - "I’m Fresh"
5/18
Ayoni - "You Said I Love You Too Soon"
Blessd - "10 PM"
Desiigner - "WAIT FOR U REMIX"
John Legend - "DOPE" ft. J.I.D.
Kristiane - "State Lines"
Maxo Kream - "JIGGA DAME"
黃凱逸 (Zelos Wong) - "騷 (Show)" ft. Luna Is A Bep
​sophiemarie.B - "Trouble"
Tommy Torres & DELIĆ - "Poco a Poco"
Will Linley - "​i don’t wanna be yours"
Yungeen Ace - "It Go"
5/19
10KDunkin - "G-CODE" ft. Eyedress
許廷鏗 (Alfred Hui) - "煽風點火 (Fan the Flames)"
Asian Doll - "To The Moon Freestyle"
Bella Shmurda - "Fvck Off"
Camilo - "Pegao"
Cold Hart - "FLIPSONG"
Conan Gray - "Yours"
Chris Jedi, Chencho Corleone, Anuel AA & Ñengo Flow - "La Llevo Al Cielo"
Eladio Carrión & NICKI NICOLE - "Nota"
Farruko - "Nazareno"
FKJ - "A Moment of Mystery" ft. Toro y Moi
Gareth.T - "confidence"
Headie One & Gazo - "22 Carats"
Jason Derulo - "Slidin'" ft. Kodak Black
Jason Derulo - "Slidin' (Solo)"
Julietta - "Something Better"
Kent Jamz - "All The Smoce" ft. GoodJoon
Kevtopo, Nohemy & Toxicboys - "Trance"
小塵埃 (Lil' Ashes) - "finish it don't quit"
Luis Figueroa - "Vienes"
Lupe Fiasco - "AUTOBOTO" ft. Nayirah
M Huncho - "Pray 2 The East" ft. BNXN fka Buju
Mariah Angeliq - "A Kind of Magic (Coke Studio Session)"
Mili - "world.execute(me); (Key Ingredient ver.)"
Pardison Fontaine & Mr. Chicken - "Safe Word"
Peiker El Tira Letra - "KARMA (Remix)" ft. Rc La Sensación & Tivi Gunz
Rina Sawayama - "This Hell"
Sech - "Noche de Teteo"
Selfmxdebless - "!ERASEHIM!"
Sophia Scott - "More Me"
Steff - "Pa PRIVE"
Taichu & Tiago PZK - "FASHION DILLER"
TINI - "Carne y Hueso"
Wafia - "In the Honey"
5/20
070 Shake - "Body" ft. Christine and the Queens
洪助昇 (Aiden Hung) - "憑實力單身 (Single By Willpower)"
Aitch - "1989"
Alexander Oscar - "Beauty & The Joke"
Ali Gatie - "IDK"
Ally Salort - "Stranger Things"
Avery Lynch - "Love Of My Life"
Ayanis - "U Betta" ft. Kali
bbno$ - "piccolo"
Ben Platt - "Grow As We Go (Remix)" ft. Sara Bareilles
Blu DeTiger & Chromeo - Blutooth
Blu DeTiger & Chromeo - ​enough 4 u
Blueface & DDG - "Meat This"
Brennan Savage - "Mood Switch"
Call Me Karizma - "Sad Money"
Carlitos Rossy - "Tus Besos"
CG5 - "Bred to be Bad"
Chalynn - "What You Do"
Dímelo Flow, Wisin & Ozuna - "Crazy" ft. Jay Wheeler, Lenny Tavárez & Arcángel
Elisama - "Demasiado Rico"
Em Beihold - "Too Precious"
FaZe Kaysan, Sheck Wes & Fivio Foreign - "MVP"
FCG Heem - "Walkin Lick"
Forest Blakk - "Give You Love"
Fousheé - "​i'm fine"
French Montana - "Alcatraz"
Hayley Kiyoko - "for the girls"
Hurricane Wisdom & YNW BSlime - "How It Feels"
​iLoveMakonnen - "Too Faded"
Jada Kingdom - "Last Night"
Jacquees - "Say Yea"
Jasiah & Lil Darkie - "SCORN"
Kapla y Miky - "Bajo Perfil"
Kuttem Reese - "Back In That Mode"
Laura Marano - "​​breakup song"
Lauri Garcia - "CTM"
​​LeAnn Rimes - "the only" ft. Ziggy Marley, Ledisi & Ben Harper
Lil Kee - "Automatic"
Lil PJ - "South Side"
Lilyisthatyou - "Gorgeous Gorgeous Girls"
Logic - "Vinyl Days" ft. DJ Premier
Louie Ray - "Out of My Hand" ft. Lil Migo
Luh Kel - "Be This Way"
Mabel & 24kGoldn - "Overthinking"
Mikey Polo - "RED+++"
Morat & Duki - "París"
NLE Choppa - "Set Up Story, Pt.1"
Oliver Tree - "I Hate You"
OMB Peezy - "Mufasa" ft. G Herbo
Paris Jackson - "lighthouse"
Pollari - "Blessing"
Quavo & Takeoff - "HOTEL LOBBY (Unc and Phew)"
Raquel Sofía - "Plan Z" ft. Pedro Capó
Sael - "Lucifer"
Sara Diamond - "Happy With Me"
Shaybo - "Crocs"
Slump6s - "Juggernaut"
Sprite Lee - "Style" ft. Lil Skies
Supa Bwe - "BUGGIN"
The Change - "Cicatrices"
The Notorious B.I.G. - "G.O.A.T." ft. Ty Dolla $ign & Bella Alubo
THEY. - "Blu Moon"
Tory Lanez - "It Doesn't Matter"
Transviolet - "Run Towards the Monster"
Tyler Hubbard - "5 Foot 9"
Solis Mist - "You..."
Unlike Pluto - "Fool's Paradise"
Yung Filly - "Long Time"
5/22
kayan9896 - "Not too close"
Soulja Boy - "Epidemic" ft. Boosie Badazz

5/23
Alex G - "Blessing"
BasedNas - "​​do it"
Cazzu & María Becerra - "Maléfica"
衛蘭 (Janice Vidal) - "現代戀愛安全手冊 (Love 101)"
NateWantsToBattle - "Mixed Nuts (From "Spy x Family")"
Selfmxdebless - "SLICE UP"
5/24
Duwap Kaine - "Off the Lean"
K CAMP - "Woozie"
Kai Whiston - "Between Lures"
Luna is a Bep - "overthinking"
​my little airport - "嘔吐 (Nausea)"
Ohana Bam & Cozz - "Play Games Witchu"
Rico Nasty - "Intrusive"
5/25
BLK ODYSSY & Baby Rose - "COMPLEX OF KILLING A MAN"
care - "MUREDERER IN VELVET JEANS"
Empress Of - "Dance For You"
JNYBeatz - "No More Words To Say" ft. 朱琳 (Ivory Chu) & 蛋撻頭 (Delta T) (HKG)
Kelly Clarkson - "Happier Than Ever"
​koi - "200 bucks"
Matoma & JP Cooper - "Midnight Sun"
Noga Erez - "NAILS"
PGF Nuk - "Talk My Shit"
Sky Ferreira - "Don't Forget"
Sleepy Hallow - "Die Young" ft. 347aidan
Tessa Violet - "BREAKDOWN"
Tony Shhnow - "Keep In Touch"
​wolfacejoeyy - "50"
YN Jay - "Shake That A$$ Baby"
Zelly Ocho - "Internet Punch"
5/26
Bhavi & Bizarrap - "PUFF"
Cixqo - "Reckless" ft. Pompay, Breana Marin
C.R.O & Negro Dub - "Otra Vez Te Soñé"
DoRoad - "NFTs"
Emanero, Rusherking & FMK - "BANDIDO" ft. Estani
Ir Sais, Farina & Konshens - "Flauta"
鄭欣宜 (Joyce Cheng) - "我地 (ngo5 dei6)"
Juliito - "Coscucaracha"
Kwengface - "Step Out." ft. DUSTY LOCANE
LIT killah & Lil Mosey - "Bipolar"
Mak Sauce - "Lit" ft. Lonny P
Manuel Turizo - "La Bachata"
M.I.A. - "The One"
Mimi Webb - "Goodbye"
Rezz & fknsyd - "Sweet Dreams (Are Made of This)"
SleazyWorld Go - "Sleazy Flow (Remix)" ft. Lil Baby
Soulja Boy - "Sippin Wock"
Wisin & Yandel, Jhay Cortez & Sech - "Llueve"
岑寧兒 (Yoyo Sham) - "這裡 (Being Here)"
XYLØ - "​red hot winter"
5/27
Alejandro Santamaria & Jerry Di - "OBSESIONADO"
Alexa Cappelli - "Could’ve Just Left Me Alone"
Alexander 23 - "The Hardest Part"
Alkaline - "Static"
Anuel AA - "¿Qué Nos Pasó?"
Armin van Buuren - "Feel Again" ft. Wrabel
Bad Gyal - "La Prendo"
Bankrol Hayden - "Van Hayden"
Beéle, Myke Towers & Feid - "Barranquilla Bajo Cero"
blackbear - "gfy" ft. Machine Gun Kelly
Bobby Shmurda - "Getting Em Back"
BRS Kash - "New Money"
Bryce Vine - "y can’t we b friends?"
Calvin Harris, Dua Lipa & Young Thug - "Potion"
CG5 - "Mommy’s Here" ft. Nola Klop & Elsie Lovelock
​Chance the Rapper - "A Bar About a Bar"
Christian French - "golden years"
Cosette - "Strings"
Dixie - "Wild"
Dee Watkins - "Cardi B"
Duwap Kaine - "Loded Diper"
Ewan Mainwood - "Worry"
Felix Jaehn - "Do It Better" ft. Zoe Wees
Gabbie Hanna - "Trouble"
JAY MAX - "Los Dos"
Jex Nwalor - "Come Back"
Jimmie Allen & Jennifer Lopez - "​on my way"
Jonas Blue & Julian Perretta - "Perfect Melody"
Jordan Davis - "What My World Spins Around"
JYDN HILL - "3Am"
Kaash Paige & Lil Tjay - "24 Hrs"
KAMILLE - "learning"
Kanye West & XXXTENTACION - "TRUE LOVE"
Kevin Powers - "Melody"
Kill Jasper - "Backdoor"
KYOTTO & Tomás García - "Mentiras"
Logan Michael - "Leave Me Alone"
Logic - "Orville" ft. Like & Blu & Exile
Luclover - "ROSE GOLD"
Maddy Hicks - "Kinda Over It"
Max Drazen - "Let Me Down Slow"
Mike Posner & The Futuristics - "Turn Up"
Moderatto & Aitana - "Sálvame"
Moneybagg Yo - "See Wat I'm Sayin"
Naaz - "Sad Violins"
NEIKED, Anne-Marie & Latto - "I Just Called"
Nuski2Squad - "Sport Mode"
Pia Toscano - "I'm Good"
Real Boston Richey - "Certified Dripper"
Rei Brown - "Thinking Bout You" ft. Joji
Rockit Music - "One Bite"
Sad Frosty, DC The Don & BIG TEEZO - "GANG GANG"
Sadie Jean - "WYD Now? (Remix)" ft. Zai1k & Zakhar
SERA - "She Kissed Me First"
Sigma - "Give It to Me" ft. Kelly Kiara & ZieZie
Squash - "Destiny"
YoGambii & Jamby El Favo - "Shorty"
5/28
CeeFineAss - "Let 'Em"
5/29
Acid Souljah - "When I Wake Up"
The Hertz (HKG) - "So Deep!"
5/30
CG5 - "Noot Noot"
Christina Aguilera & TINI - "Suéltame"
CY 陳宗澤 - "神經刀 (Psychotic)"
Emilia & NICKI NICOLE - "intoxicao"
Lil Yachty & DC2Trill - "Set It Off Freestyle"
5/31
Brandon Kai - "Red Hot"
CHRIST DILLINGER - "Play Bout It [remix]" ft. Swami
cupcakKe - "H2hoe"
DJ Snake - "Disco Maghreb"
glaive - "pretty stupid lol (77)"
徐嘉浩 (Kevin Kaho Tsui) - "Take Me Back"
Lil Loaded - "Cell Tales"
​salem ilese - "Crypto Boy"
Vory - "Daylight" ft. Kanye West
Why Don’t We - "How Do You Love Somebody"Embed I Was Made For Lovin' You - Single Mix KISS 40 KISS hard-rock