2 ContributorsNew Music Friday 05/29/20 LyricsLady Gaga - Sour Candy (with Blackpink)
Juice WRLD - Tell Me U Luv Me (with Trippie Red)
ROSALIA - TKN (feat. Travis Scott)
Kygo - Broken Glass (feat. Kim  Petras)
Lil Yachty & Tierra Whack - T.D. (feat. A$AP Rocky & Tyler, The Creator)
D Smoke - Let Go (feat. SiR)
Alec Benjamin - Match In the Rain
Diplo - Dance With Me (feat. Thomas Rhett & Young Thug)
Ali Gatie - Running On My Mind
No Rome - Hurry Home (feat. beabadoobe & Jay Som)
Lady Gaga - Free Woman
Tones And I - Ur So F**kIng cOol
Anuel AA - Futbol & Rumba (feat. Enrique Iglesias)
Gucci Mane - Both Sides (feat. Lil Baby)
6lack - ATL Freestyle
Galantis & Ship Wrek - Only A Fool (feat. Pink Sweat$)
Quin XCII & Logic - A Letter To My Younger Self
Oliver Tree - Bury Me Alive
Jack Larsen - Dog Eat
Freddie Gibbs & The Alchemist - Something To Rap About (feat. Tyler, The Creator)
Jessie Reyez - Headlines - Recorded at Spotify Studios NYC
Lucky Daye - Shoulda (feat. Babyface)
G Herbo & Lil Uzi Vert - Like This
SAINt JHN - Roses Remix (feat. Future)
G-Eazy - Stan By Me
Baby Queen - Internet Religion
ROLE MODEL - for the people in the back
Remi Wolf - Disco Man
[The Raconteurs - Blank Generation (Studio Version) - Recorded at Electric Lady Studios]()
Gabriel Garzón-Montano - Someone
boy pablo - hey girl
Powfu - a world of chaos (feat. Rxseboy, Jomie & Ivri)
X Lovers - Mad World
Aminé - Riri
GASHI - Paranoid
DaniLeigh - Dominican Mami (feat. Fivio Foreign)
Kevin Gates - Grandmotha Grave
Young Dolph - RNB (feat. Megan Thee Stallion)
Kevin George - Changes
Christian Leave - No Use
boylife - dio
Cigarettes After Sex - You're All I Want
Ne-Yo - U 2 Luv
Aitch - 30
Shoreline Mafia - Ride Out (feat. Lil Yachty)
JayDaYoungan - Touch Your Toes (feat. Mulatto)
RMR - I'M NOT OVER YOU
Orville Peck - No Glory in the West
Celeste - I Can See The Change
mike. - 2 birds
Scott Storch - Fuego Del Calor (feat. Ozuna & Tyga)
Monsta X - FANTASIA
Travis Barker - Drums Drums Drums
Ro James - Be Mine
Bruno Major - Figment Of My Mind
Griff - Forgive Myself
Phil Good - Everything's Good
Bright Eyes - One and Done
Grady - kissing girls
Old Dominion - I'm On It
I Prevail - DOA [Feat. Joyner Lucas]
Yung Baby Tate - B.O.M.B.S.
Tayla Parx - Dance Alone
Andra Day - Make Your Troubles Go Away
Cam - Redwood Tree
Dolly Parton - When Life Is Good Again
Chiquis - Jolene
Destiny Rogers - On 11
ALX - Crash
yaeow - I Need U
Willy Cardiac - Fan of Me
9lokknine - Why You Lying
22Gz - YTB (Yellow Tape Blixky) [feat. Shawny Binladen & Big Yaya]
Toosii - Club House
Ricky Martin - Recuerdo
Robin Thicke - Forever Mine
[Terrell Hines - Promise]()
Ray LaMontagne - Strong Enough
Winona Oak - Oxygen
Nova Miller - Mi Amor
Kelsey Lu - Morning Dew
DWY - Latchkey
Tank and The Bangas - For André
Anna Sofia - Either Way
Kip Moore - Fire And Flame
Little Big Town - Wine, Beer, Whiskey - Radio Edit
Sarah Barrios - Mourn The Living
Bonbon Anglais - Stalemate
TeaMarrr - Chasing Amy
Kayla Nicole - Think About Me (feat. YK Osiris)
[Dee Watkins - Thinkin Bout You]()
Smokepurpp - It's Whatever
Lil Poppa - Bankrolls & Groupie Hoes (feat. Stunna 4 Vegas)
Marlon Craft - Loved
Mez - Southside Mez
Palaye Royale - Tonight Is The Night I Die
Cady Groves - Bartender
Kelvin Harrison Jr. - Track 8
Shawn Wasabi - MEDICINE (feat. Tia Scola)
CAL - CatchEmbed