2 ContributorsNew Music Friday 4/24/20 LyricsJuice WRLD - Righteous
THE SCOTTS - THE SCOTTS
The 1975 - If You‚Äôre Too Shy (Let‚ÄÖMe‚ÄÖKnow) - Edit
Alaina‚ÄÖCastillo - pass you by
YoungBoy Never‚ÄÖBroke Again - Thug Of Spades (feat. DaBaby)
Lil Baby - All In
Cautious Clay - Cheesin‚Äô (with Cautious Clay, Remi Wolf, Still Woozy, Sophie Meiers, Claud, Melanie Faye, & HXNS)
James Blake - You're Too Precious
mxmtoon - no faker
Gus Dapperton - First Aid
Regard - Secrets
SG Lewis - Chemicals
[Verzache - Life Inside]üêö
StaySolidRocky - Party Girl
Missy Elliott - Cool Off
Charli XCX - claws
Lennon Stella - Older Than I Am
Alicia Keys - Good Job
Wiz Khalifa - Y U Mad (feat. Megan Thee Stallion, Ty Dolla $ign & Mustard)
Maluma - ADMV
LoveLeo - LEMONS
YUNGBLUD - Weird!
Breland - My Truck (feat. Sam Hunt) - Remix
Kane Brown - Cool Again
Kina - Feel Again (Feat. Au/Ra)
Alina Baraz - Off the Grid (feat. Khalid)
Lil Skies - Fidget
DJDS - No Trust (Feat. Bibi Bourelly & Kiah Victoria)
UMI - Mother
Masego - Veg Out (Wasting Thyme)
Isaiah Rashad - Why Worry
Ab-Soul - Dangerookipawaa Freestyle
SiR - Rapper Weed
REASON - Might Not Make It
Zacari - Edamame
D√≠melo Flow - Pirueta
Tana Mongeau - without you
Cheat Codes - On My Life
Malia Civetz - Heart Broke
T-Pain - Wake Up Dead
Fivio Foreign - Demons & Goblins (feat. Meek Mill)
K CAMP - What's On Your Mind (feat. Jacquees)
Young Dolph - Sunshine
Kali Uchis - i want war (BUT I NEED PEACE)
Huron John - Motocross
Charlie Burg - Channel Orange In Your Living Room
The Rolling Stones - Living In A Ghost Town
The Killers - Fire In Bone
Goody Grace - If I Want To
lilspirit - nobody else
Earl Sweatshirt - WHOLE WORLD (feat. Maxo)
[Stunna 4 Vegas - Freestyle]üêö
Woodkid - Goliath
chloe moriondo - Bugbear
Lolo Zoua√Ø - It's My Fault
Bright Eyes - Forced Convalescence
Tom Misch - Last 100
Octavian - Poison (feat. Take A Daytrip, Obongjayar, Santi)
Mulatto - No Hook
Flo Milli - Eat It Up
Lil Pump - Illuminati
Raja Kumari - N.R.I.
JoJo - Lonely Hearts
Taylor Janzen - Devotion
Stephanie Poetri - Straight To You
Keith Urban - Polaroid
AWOLNATION - Pacific Coast Highway In The Movies (feat. Rivers Cuomo of Weezer)
MOD SUN - Stay Away (feat. Machine Gun Kelly & Goody Grace)
Victoria Mon√©t - Dive
[Lil Gotit - Yeah Yeah (feat. Future & Lil Keed)]üêö
[Lonr. - LIT (feat. 24kGoldn)]üêö
Asher Roth - Way More Fun (feat. Lil Yachty)
[Nick Leng - Walking Home to You]üêö
Shawn Wasabi - LEMONS (feat. kennedi)
Chelsea Peretti - CHORE
Chloe Lilac - Moderation
Hayley Williams - Dead Horse
Tom Grennan - Oh Please
Njomza - Bite
Ro James - Selfish
Trouble - Uh Huh
Shoreline Mafia - Gangstas & Sippas (feat. Q Da Fool)
Smooky MarGielaa - Rock$tar
Guapdad 4000 - Trade Places With Them Jeans
DDG - OD
[Bantu - Somebody]üêö
Sarah Barrios - I Didn't Mean To
Loote - Sex With My Ex
david hug√∏ - The Least Of Me
joan - love me better
[Emmanuel Franco - Broken Man]üêö
Day Wave - Crush
Hazel English - Wake UP!
Nick Hakim - CRUMPY
John Paul White - We're All in This Together Now
OSTON - Shrug
Montana Tucker - Hola
Leven Kali - PERFECT IS BORING
Rubi Rose - Pretty MF
TyFontaine - OpportunityEmbed