1 ContributorNew Music Friday 06/24/22 LyricsBeyonc√© - BREAK MY SOUL
Lil Nas X - Late To Da Party (feat. Youngboy Never Broke Again)
Luke Combs - Outrunnin' Your Memory ft. Miranda Lambert
Taylor Swift - Carolina
Roddy Ricch - Real Talk
Imagine Dragons - Sharks
Eminem - From The D 2 The LBC (with Snoop Dogg)
Charlie Puth & Jung Kook - Left and Right
Dove Cameron - Breakfast
Gorillaz - Cracker Island (feat. Thundercat)
Conan Gray - Disaster
Lil Durk - Did Shit To Me (feat. Doodie Lo)
Chris Brown - Psychic
GIVƒíON - Lost Me
Machine Gun Kelly - 9 lives
Brent Faiyaz - PRICE OF FAME
WILLOW -  it's my fault
Moore Kismet - See You Go
Jimmie Allen - be alright
Kacey Musgraves - Can't Help Falling in Love
Justin Quiles - AEIOU
Glaive - minn–µsota is a place that exists
Leah Kat–µ - Twinkle Twinkle Little Bitch
Dayglow - Then It All Goes Away
Jessie Reyez - FRAUD
DaBaby & Davido - SHOWING OFF HER BODY
Bbno$ - pogo
Dimitri Vegas - The Drop
Elley Duh√© - PIECES
Nessa Barrett - die first
MUNA - What I Want
Mura Masa - hollaback bitch (with Shygirl & Channel Tres)
Sam Hunt - Water Under The Bridge
YG - Run (feat. Tyga, 21 Savage & BIA)
FLETCHER - Her Body Is Bible
Avril Lavigne - Hello ‚Äì Spotify Singles
Djo - Change
Bored Brothers - DRIP
Alex G - Runner
Peach Tree Rascals - Let U Go
Dylan Conrique - i miss you (skin to skin)
Duki - Celosa
Cochise - FINALLY
H.E.R. - Dance To The Music
Noah Cyrus - Ready to Go
French Montana - Keep It Real
Coi Leray - Involved
Meghan Trainor - Bad For Me (feat. Teddy Swims)
Tove Lo - True Romance
David Kushner - Burn
Prince Royce - Si Te Preguntan...
Kalan.FrFr. - No Stoppin ft. BlxstKalan
Empress Of - Turn The Table
J.I the Prince of N.Y - Relapse
Tai Verdes - sheluvme
Ashe - Angry Woman
Sam Feldt & salem ilese - Hate Me
Jack Johnson - Don't Look Now
Soccer Mommy - Feel It All The Time
Christine and the Queens - Je te vois enfin
Ari Abdul - Taste
Stunna 4 Vegas - Stand Off (feat. DaBaby)üïõ
Masked Wolf - Jenny I‚Äôm Sorry (feat. Alex Gaskarth From All Time Low)üïõ
Ozzy Osbourne - Patient Number 9 (feat. Jeff Beck)
Day Wave - See You When The End's Near
COBRAH - BRAND NEW BITCH
Alexander 23 - Somebody's Nobody
James Bay - Everybody Needs Someone
Ray Vaughn - Mannequin üêö
Caamp - The Otter
Lady A - Summer State Of Mind
NERIAH - Missing Somebody
Hayley Kiyoko - deep in the woods
Aitch & Bakar - In Disguise
Highly Suspect - Natural Born Killer
Weezer - Records
Yandel - Nunca y Pico
Lupe Fiasco - NAOMI
Aespa - Life‚Äôs Too Short (English Ver.)
Isabel LaRosa - HEAVEN
Aidan Bissett - Twenty Something
Wiz Khalifa - Bad Ass Bitches
Boslen - GONE
Mehro - pirate song
Byron Juane - LOMLüïõ
Ondara - An Alien In Minneapolis
Ethan Bortnick - Engravings
Julia Wolf - Hot Killer
Sophie Cates - Nasty
The Mars Volta - Blacklight Shine
Coheed and Cambria - A Disappearing Act
Dhruv - Blur
First Aid Kit - AngelYou might also likeEmbed