1 ContributorNew Music Friday 09/30/22 LyricsParamore - This Is Why
Ed Sheeran - Celestial
YG – Sober
dvsn - What's Up (feat. Jagged Edge)
Tate McRae - uh oh
Shawn Mendes - Heartbeat)
Quavo & Takeoff - Nothing Changed
Maluma - Junio
Shygirl - Shlut
Kid Cudi - My Drug
LCD Soundsystem - new body rhumba (from the film White Noise)
EKKSTACY - im so happy
Roddy Ricch - Stop Breathing
Freddie Gibbs - Pain & Strife (feat. Offset)
Yeah Yeah Yeahs - Wolf
Bruce Springsteen - Do I Love You (Indeed I Do)
Charlie Puth - Charlie Be Quiet!
BoyWithUke - Sick of U (with Oliver Tree)
Maude Latour - 001
Russell Dickerson - I Wonder
Trippie Redd - Save Me, Please
Smino - 90 Proof (feat. J. Cole)
Arctic Monkeys - Body Paint
quinnie - man
Wisin & Yandel - Besos Moja2
Tory Lanez - This Ain’t Working
24kGoldn - Mistakes
Reneé Rapp - Don't Tell My Mom
Aluna - Kiss It Better
DDG - 9 Lives (feat. Polo G & NLE Choppa)
Ciara - Better Thangs (with Summer Walker)
Björk - Fossora
Slipknot - Hive Mind
Adam Doleac - Til Dawn Do Us Part
Tyler Childers - Way of the Triune God - Jubilee Version
Cautious Clay - Burning Up Slow
Gabriels - If You Only Knew
Kodak Black – I'm So Awesome
Kenny Mason - MINUTE FOREVER
skaiwater - boys don’t cry
Precious Pepala - Looking for Trouble
M.I.A. - Beep
Don Omar - LET'S GET CRAZY! (Mambo Drop)
Alan Walker - Extremes
Teddy Swims - Someone Who Loved You
Amandla Stenberg - Alice (Bodies Bodies Bodies)
LØLØ - boohoo
Baby Tate - Differences
Honey Dijon - Show Me Some Love (feat. Sadie Walker)
Whethan - Fall Out Girl
Sofía Valdés & Pink Sweat$ - Broken
Dylan Conrique - get over you
Sarah Kang - end credits
KSI - Summer Is Over
BLEU - Life Worth Living
Ronald Isley - The Plug
Christine and the Queens - rien dire
Hyd - Breaking Ground
Bladee - HAHAH
Craig David - Obvious (feat. Muni Long)
Natti Natasha - LOKITA
Anson Seabra - 18
Daniel Seavey - Can We Pretend That We're Good?
Leah Kate - Monster
First Aid Kit - Turning Onto You
Ashley McBryde - Bonfire At Tina's
Savannah Ré - Many Men - Spotify Singles
Angèle - Amour, Haine et Danger
dodie - Lonely Bones
glaive - three wheels and it still drives!
Men I Trust - Billie Toppy
Malaa - Outcast (with Fivio Foreign)
Kranium - Without You (feat. Queen Naija)
Chxrry22 - Wasteland
MAVI - Doves
grentperez - Day By Day
Warren Zeiders - Heavy Pour
HARDY - JACK
Sarah Cothran - I'm Here
Hailey Knox - Waiting on You
Debbie - Cherry Wine
Kenyon Dixon - Getting Late
BIG30 - Celine Frames
khai dreams - Bugs
Melody's Echo Chamber - Norfolk Hotel
Sure Sure - California High
The Maine - Box in a Heart (with renforshort)
Giovannie and the Hired Guns - Overrated
Zach Williams - Jesus' Fault
Show Dem Camp - Live Life
Johnny Yukon - The Start
Abigail Osborn - Don't Have the Heart
Anna Vaus - Younger Version of Myself (feat. Abby Anderson)
Social Club Misfits - Got What You Need
Searows - Keep The Rain
Naïka - M&M’s for Breakfast
Stevie Bill - Messy
RUNNER BOY - BACKWARDS
Softee - MollyEmbed