2 ContributorsNew Music Friday 3/12/21 LyricsSelena Gomez - D√°melo To‚Äô (feat. Myke Towers)
Rod Wave - Street Runner
CHIKA - CINDERELLA, Pt. 2
Giveon - All To Me
ILLENIUM - First Time
Nick Jonas - 2Drunk
ROS√â - On The Ground
Imagine Dragons - Follow You
Brent Faiyaz - Show U Off
Blxst - Fck Boys
YBN Nahmir - Fast Car Music (STAIN)
Ali Gatie - Can't Let You Go
WATTS - Feels (feat. Khalid)
Machine Gun Kelly - DAYWALKER! (feat. CORPSE)
NF - LOST (feat. Hopsin)
Phoebe Bridgers - Summer's End - Spotify Singles
Noah Cyrus - re: Stacks - Spotify Singles üêö
D Smoke - Sade - Spotify Singles üïí
CHIKA - My Future üïí
Jorja Smith - Addicted
Anson Seabra - It's Raining, It's Pouring
b√ºlow - First Place
THE BLOSSOM - SHAPESHIFTER
spill tab - PISTOLWHIP
Lil Eazzyy - Yes or No (feat. IV JAY)
Foushe√© - sing about love
Danny Ocean - Cu√°ntas veces
Gwen Stefani - Slow Clap
AJ Mitchell - CAMERAS ON
Joshua Bassett - Telling Myself
6 Dogs - When I Was a Baby
Kenny Mason - Pup
Jhen√© Aiko - stranger
KSI - Patience (feat. YUNGBLUD & Polo G)
MOD SUN - Heavy (feat. blackbear)
Lady A - Like A Lady
Darius Rucker - My Masterpiece
BANNERS - If I Didn't Have You
SHAED - Part Time Psycho (with Two Feet)
MASN - 2 Times
Belaganas - Jacknife
Benny The Butcher - Thanksgiving
Kid Ink - Red Light üïí
FRVRFRIDAY - TIME FOR YOU
Laura Les - Haunted
London Grammar - How Does It Feel
Leyla Blue - Gasoline
Leah Kate - Boyfriend
Shoffy - I'll Be Home Soon
twocolors - Bloodstream
San Holo - IT HURTS!
Max Leone - the craziest thing i've ever done
070 Beheard - Said
Jhay Cortez - Christian Dior
Simon Dominic - Party Forever
Tom Grennan - Never be a Right Time
Grouplove - Deadline
Allison Ponthier - Cowboy
Lexi Jayde - Newbury Park
Anna Clendening - Love Song - feat. John K
TELYKast - Nobody To Love (with Loren Gray)
Cannons - Bad Dream
Valerie June - Smile
Tiera - Not Your Girl
LunchMoney Lewis - Ocean (feat. Meghan Trainor)
X Ambassadors - torture (with Earl St. Clair)
Guapdad 4000 - She Wanna (feat. P-Lo)
Kalan.FrFr - Look At Me
Clever - Call Me Nobody (feat. Lil Wayne & Isaiah Lyric)
Kasai - Drunk Diary, Weed & Liquor
slenderbodies - focus (with Tim Atlas)
Raissa - COLD FEET
Crumb - Trophy
Luna Li - Cherry Pit
Sage The Gemini - BABY
Slimelife Shawty - No Brakes
YSB Tril - Touchdown (with Bankrol Hayden)
Stephanie Poetri - Paranoia
Declan J Donovan - Before You Let Me Go
Gunnar Gehl - Dance Alone
Jacob Banks - Found
Lucy Dacus - Thumbs
Damien - Ashes üïí
Yungeen Ace - Gun Em Down
BONES - PopRocks
Quin Nfn - Right Now (feat. Stunna 4 Vegas)
Pote Baby - YAMS!
Moore Kismet - Vendetta For Cupid üïí
Wilderado - Head Right
Ellise - Feeling Something Bad...
Thuy - chances
Lake Street Dive - Lackluster Lover
Baby Boys - Maggot Water
NLE Choppa - Big Steppa
TyFontaine - Run It Up (feat. SoFaygo)
Wacotron - Checclist
Pitbull - Ten Cuidado
LASTMONDAY - Younowut√°mean
Kavale - Rendezvous
Jayy Grams - Moment of Truth üêöEmbed