14 ContributorsSeptember 2020 Singles Release Calendar Lyrics9/1
Actress - "Walking Flames" ft. Sampha
Allan Kingdom - "EXCITED"
Gabi DeMartino - "Champagne Dreams"
Mozzy - "Death is Callin"
Winona Oak - "With Myself"
YoungBoy Never Broke Again - "Callin" ft. Snoop Dogg

9/2
A Boogie wit da Hoodie, Don Q & Trap Manny - "Vroom Vroom"
Adrianne Lenker - "anything"
Bring Me the Horizon & YUNGBLUD - "Obey"
Cheat Codes - "Between Our Hearts" ft. CXLOE
FINNEAS - "What They'll Say About Us"
Foxes - "Friends in the Corner"
glaive - "arsenic"
Gus Dapperton - "Medicine"
Hedda Mae - "Madness"
Hot Chip - "Candy Says"
JP Saxe - "A Little Bit Yours"
Katy Perry - "Smile (Joel Corry Remix)"
Katy Perry - "Smile (Joel Corry Extended Remix)"
Lido - "Layaway"
Marina Kaye - "Double Life"
Marshmello & 42 Dugg – "Baggin"
Now United - "Na Na Na (Spanish Version)"
Shygirl - "Freak"
The Struts & Robbie Williams - "Strange Days"
tiger lili - "lightning"
Unlike Pluto - "Wouldn’t You Agree"
Yung Gravy - "yup!"
9/3
Anna Clendening - "Sorry That I Do That"
Ari Lennox & Anthony Ramos - "If You Want Me To Stay"
AURORA - "The Secret Garden"
Ava Max - "OMG What's Happening"
Bryson Tiller - "Inhale"
changing cleo - "gold"
Lil Duke & Hoody Baby - "Beat It"
Lil Duke - "Nobody On E"
Ozuna & Camilo - "Despeinada"
Paloma Faith - "Better Than This"
Paul Epworth - "Mars & Venus" ft. Elle Yaya, Ishmael & Vince Staples
VanJess - "Come Over"
9/4
8ubbles - "Electric Lies"
Aaron Carpenter - "Bite"
Aloe Blacc - "Hold On Tight"
Amber Riley - "A Moment"
American Authors - "Counting Down"
Anna Straker & Gabrielle Aplin - "Good Days Bad Days"
Audrey Mika - "Red Gatorade"
B.o.B - "ZZZ's"
Birdy - "Open Your Heart"
BKTHERULA - "Admit It"
Blithe - "If I Ain’t The One"
Bow Anderson - "Island"
Carly Pearce - "Next Girl"
Chloe x Halle & Doja Cat - "Do It (Remix)" ft. City Girls & Mulatto
Dagny - "It's Only a Heartbreak"
Derivakat - "I Need You"
DJ Envy - "Sittin' In My Car" ft. A Boogie wit da Hoodie & Fabolous
Dua Saleh - "RE(a)D (with Bas)" ft. Bas
Eden xo - "Paradise Found"
Eric Bellinger - "Godly"
FBG Duck - "Yeahh"
Fickle Friends - "What A Time"
Finn Askew - "Peach"
FLETCHER - "The One"
FRANKIE - "Home Alone"
G-Eazy - "Down" ft. Mulatto
GARZI - "STAINS"
Gia Woods - "CHAOS"
Goss - "Everybody's Going"
Hermitude - "Spotlight" ft. Daniel Bedingfield
HRVY & Matoma - "Good Vibes"
ionnalee - "MACHINEE"
Jackson Wang & Galantis - "Pretty Please"
Jac Ross - "It's OK To Be Black 2.0" ft. D Smoke & Buddy
Jawsh 685 - "Sweet & Sour" ft. Lauv & Tyga
Joshua Radin - "America"
Julia Stone - "Unreal"
Kelsy Karter - "Love Me or Hate Me"
LAXX - "The Invasion"
Like Saturn - "Otherworldly"
Lil AK - "Uber Eats Freestyle"
Lil Durk - "The Voice"
Lil Loaded - "High School Dropout"
Lil Toe - "Crème Brûlée"
Lil Tracy - "Messy"
LION BABE - "Umi Says"
Lost Kings - "Hurt" ft. DeathbyRomy
LOVA - "One Day Left"
LYRA - "New Day"
Mabes - "Danny"
Maria Mena - "You Live and You Learn"
Matilda Mann - "Happy Anniversary, Stranger"
MAX - "Working for the Weekend" ft. bbno$
McFly - "Growing Up" ft. Mark Hoppus
Melvoni - "PENNY UP"
MOLI - "Jacuzzi"
Palace - "I'll Be Fine"
Perto - "I Miss You" ft. Banoffee
Phora - "Destiny's Song"
Ramirez - "Children of the Void" ft. SosMula
Scarlet Pleasure - "Push-Ups"
Sigala & James Arthur - "Lasting Lover"
Slum Sociable - "Explain Myself"
Sofía Reyes, Darell & Lalo Ebratt - "Échalo Pa' Ca"
Starley - "Let Me In"
SZA - "Hit Different" ft. Ty Dolla $ign
Tay Money - "On Me"
The Stupendium & Bonecage - "Losing My Patients"
Thomas Headon - "UrbanAngel1999"
tobi lou - "Endorphins"
Toosii - "Poetic Pain"
Torine - "Stupid Things"
Vargas & Lagola - "Always"
Xan Griffin - "Afflicted" ft. Beau Rich
XYLØ - "Lefty"
YSN Flow - "Blow It All" ft. OSIBIH
Yuna - "Invisible"
9/5
M.E.T.A.L. - "End His Reign"
9/6
Eli Sostre - "Made It pt. 2/Can’t Stay"
Gray Joy - "Dive Right In"
Los Negritos - "Estar Legal"
9/7
Aaron Golden - Just Friends
Chaz Cardigan - "Live A Little"
Deko - "december"
Maeta - "Teen Scene" ft. KAYTRANADA & Buddy
NateWantsToBattle - "Hello Neighbor"
osquinn - "oblivion" ft. blackwinterwells
Yellow Days - "The Curse" ft.  Mac DeMarco

9/8
beabadoobee - "Worth It"
Berner - "R.I.P" ft. Tee Grizzley
Janelle Monáe - "Turntables"
Kiiara - "Numb" ft. Deathbyromy & PVRIS
​​guccihighwaters - "expectations"
Luke James & KIRBY - "all of your love (Remix)"
Meghan Trainor - "Make You Dance (Jay Dixie Remix)"
Meghan Trainor - "You Don’t Know Me (Sidekick Remix)"
New Order - "Be a Rebel"
Quada - "Nuh Carry News"
YoungBoy Never Broke Again - "Soul Stealer"
9/9
637GODWIN - "Kickflip freestyle"
Aesop Rock - "The Gates"
Bailey Bryan - "Roster"
Comethazine - "Air Max"
Dixie D'Amelio & Lil Mosey - "Be Happy (Remix)" ft. blackbear
Dreamer Boy - "Know You"
FLETCHER - "Shh...Don’t Say It"
Gorillaz - "Strange Timez" ft. Robert Smith
July - "18" ft. Voda Fuji
Leyla Blue - "Company"
M.I.A. - "CTRL"
Mike Shinoda - "License to Waltz"
MISSIO - "Can You Feel the Sun"
MISSIO - "Don't Forget to Open Your Eyes"
mxmtoon - "ok on your own" ft. Carly Rae Jepsen
Of Monsters and Men - "Visitor"
Petit Biscuit - "Drivin Thru the Night"
renforshort - "nostalgic (luvsick)"
Sam Tompkins - "Charlie"
Serena Isioma - "Blue Sky"
Stats - "Naturalise Me"
Stefflon Don - "Move"
Steps - "What The Future Holds"
Tash Sultana - "Beyond The Pine"
The Pierces - "Everything"
Wallows - "Nobody Gets Me (Like You)"
9/10
Absofacto - "Someone Else's Dream"
Amenazzy, Wiz Khalifa & Myke Towers - "Jalapeño (Remix)"
Bruce Springsteen - "Letter To You"
Davido - "FEM"
Derivakat - "Breathe"
Django Django - "Spirals"
Elzhi - "Light One Write One"
Exit & boyband - "Bad Intentions"
Florida Georgia Line - "Long Live"
Grafh - "Trappin' out the Hyatt" ft. El Camino & Smoke DZA
Jack Gilinsky & iann dior - "Love Somebody"
Katie Melua - "Your Longing Is Gone"
Like Saturn - "Baklava"
M1llionz - "Lagga"
Marshmello & Demi Lovato - "Ok Not to Be Ok"
Matt Berninger - "One More Second"
Mr Eazi & Major Lazer - "Oh My Gawd" ft. Nicki Minaj & K4MO
Omar Apollo - "Kamikaze"
Rhye - "Helpless"
Ruel - "as long as you care"
Shame - "Alphabet"
Spillage Village, JID & EARTHGANG - "Baptize"
Still Woozy - "BS"
Sylvan Esso - "Frequency"
The Vamps - "Chemicals"
Tommy Ice - "Designer"
Usher - "Bad Habits"
9/11
$tupid Young & Tee Grizzley - "Wit a Sticc"
Alicia Keys - "Love Looks Better"
ALLBLACK - "Pizza Rolls" ft. Cash Kidd & DaBoii
Alycia Bella - "Cue The Sun" ft. Boogie
Annie - "The Streets Where I Belong"
AViVA - "WICKED"
Ayanis - "Lil Boi (Big Talk) [Remix]" ft. Jack Harlow
Conchita Wurst - "Lovemachine" ft. Lou Asril
Cosmo’s Midnight - "Idaho"
Danielle Bradbery - "Never Have I Ever (Acoustic Version)"
David Guetta & Sia - "Let's Love"
Delilah Montagu - "Loud"
Dizzee Rascal - "Act Like You Know"
Doja Cat - "Say So / Like That (Mashup)"
Eric Bellinger - "Solo'n"
Ferdinand - "Every Single Summer"
Fredo Bang - "No Security" ft. Kevin Gates
Guy Sebastian - "If He Won't"
Guy Sebastian - "Standing With You (The Guy Alt. Version)"
INNA & Farina - "Read My Lips"
James Blake - "Godspeed"
Jimi Somewhere - "Jesus" ft. Kacy Hill
John K - "Happiness"
Kayzo, SYN & Zero 9:36 - "Breakdown"
Jordan Davis - "Almost Maybes (Acoustic)"
Lil Playah - "Chanel Shoes!"
Lil Spacely & Korky Buchek - "Husky"
Lil Tecca - "Our Time"
LPB Poody - "Connected" ft. 42 Dugg
Lucia & The Best Boys - "Perfectly Untrue"
Ludacris & Chance The Rapper - "Found You"
Luh Kel & Queen Naija - "Want You"
Matt Bellamy - "Bridge Over Troubled Water"
Midland - "Cheatin' Songs (Montana Mix)"
Mozzy - "Streets Ain't Safe" ft. Blxst
Nerina Pallot - "Next Life"
Oliver Tree - "Cash Machine (Remix)" ft. grandson & Dillon Francis
ppcocaine - "Hugh Hefner"
Raissa - "Go Fast Baby"
S1MBA - "Loose" ft. KSI
Sarkodie - "Gimme Way" ft. Prince Bright
Seeb & St. Lundi - "Colourblind"
Shy Glizzy - "Forever Tre 7" ft. No Savage
SVEA & Alexander Oscar - "Need To Know"
T.I. - "Ring" ft. Young Thug
Tom Aspaul - "01902"
Tom Walker & Zoe Wees - "Wait for You"
Toosii - "Right Now"
Trippie Redd - "I Got You" ft. Busta Rhymes
Victoria Kimani & FKi 1st - "Afreaka (Remix)" ft. STONEBWOY
YBN Nahmir - "Pop Like This" ft. Yo Gotti
Youngs Teflon - "El Classico"
ZHU - "Risky Business"
9/12
Intence - "HAVOC"
9/13
Geko - "Investment 3style"
Jimi Tents - "On Me"
Sol Jay - "Hot Winter"
9/14
CL - "Post Up"
KILL.ZERO - "loser lol"
NateWantsToBattle - "All Endings"
Nothing But Thieves - "Impossible"
Pixey - "Just Move"
Porridge Radio - "7 Seconds"
Sa Vich - ''Planet Earth 2.0'' ft. A P Capone
The Avalanches - "Music Makes Me High"
The Avalanches - "Take Care in Your Dreaming" ft. Sampa The Great, Tricky & Denzel Curry

9/15
Andrew Jannakos - "Gone too Soon"
Cautious Clay - "Agreeable"
CG5 - "Show Yourself"
Christina Grimmie - "Cry Wolf"
Future Islands - "Moonlight"
JAHMED & Freddie Gibbs - "GLIMPSE"
Marika Hackman - "Realiti"
MAX - "Blueberry Eyes" ft. SUGA (BTS)
Rob Markman - "Still Hear the Screams" ft. DviousMindZ
slowthai - "feel away" ft. James Blake & Mount Kimbie
Sufjan Stevens - "Sugar"
Teddy Geiger - "Sharkbait"
9/16
A. G. Cook - "Beautiful Superstar"
Angel Olsen & Emile Mosseri - "Mr. Lonely"
Blood Orange & 박혜진 Park Hye Jin - "CALL ME (Freestyle)"
Dan Bull - "Grand Theft Auto" ft. NemRaps
Da$h - "Directions"
Faye Webster - "Better Distractions"
Flohio - "Unveiled"
Jacob Banks - "Stranger"
JAHKOY - "Exes & Summer Flings"
Keith Urban & P!nk - "One Too Many"
LANY - "cowboy in LA"
Lil Pump - "Life Like Me"
Local Natives - "Statues in the Garden (Arras)"
Masego - "Passport"
Melanie C - "Fearless" ft. Nadia Rose
NateWantsToBattle - "Radio Demon"
Oliver Francis - "VIOLENCE "
Papoose - "Kickback" ft. Conway the Machine & French Montana
Pentatonix - "Mad World"
Rachel Platten - "Soldiers"
Saba - "Mrs. Whoever"
Sainvil - "Boxed In" ft. Boogie
Sir Chloe - "Sedona"
Skeggs - "Fantasising"
Squash - "Potus"
Stalley - "Dinosaur"
THEY. & Juicy J - "STCU"
Trapboy Freddy - "Sum Mo" ft. 42 Dugg
Travis - "All Fall Down"
Unlike Pluto - "Wrong Faces Wrong Places"
Will Butler - "Bethlehem"
Willie the Kid - "Brewster's Millions" ft. Curren$y
Zeina - "Consequences"
9/17
Action Bronson - "Mongolia" ft. Meyhem Lauren & Hologram
Black Coffee - "Ready For You" ft. Celeste
BlocBoy JB - "ChopBloc 3 Pt. 3" ft. NLE Choppa
Brittany Howard -  "Goat Head (EARTHGANG Remix)" ft. EARTHGANG
Brittany Howard - "Short and Sweet (Bon Iver Remix)"
Bryce Hase - "​darkest ♥ hours"
contradash - "cat out the bag"
Elzhi - "Smoke & Mirrors"
Files J - "Phantom Visions"
Georgia - "Feel It (Remix)" ft. Yung Baby Tate
JAWNY - "Super Bad Mantra" ft. Christian Blue
Joy Crookes - "You & Me Song"
Kelvyn Colt - "BENZ | I Know"
Kofi Kinaata - "Coronavirus"
Kyle Allen - "Eekum Bokum"
Litany - "Starsign"
Liza Owen - "GETTIN GOOD"
Luis Fonsi & Farruko - "Perfecta"
M Huncho & Nafe Smallz - "5AM"
Moneybagg Yo - "Said Sum (Remix)" ft. DaBaby & City Girls
Pendulum - "Driver"
Pendulum - "Nothing for Free"
Pink Sweat$ - "17 (Remix)" ft. Joshua (Seventeen) & DK (Seventeen)
Rapsody - "12 Problems"
Rico Nasty - "Own It"
Saba - "Something in the Water" ft. Denzel Curry
Skepta - "No Stress" ft. Michael Phantom & L3
SUBLIMINIS - "On The Edge"
Sunflower Bean - "Moment In The Sun"
Valley - "hiccup"
Wizkid - "No Stress"
Young Nudy - "All White"
YUNGBLUD - "god save me, but don't drown me out"
9/18
27CLUB - GRAB THE WHEEL
220 KID & JC Stewart - "Too Many Nights"
A$AP Twelvyy - "S.N.L."
Akira Kosemura - "Satoko And Kiyokazu I / Asato's Memory (From "True Mothers" Soundtrack)
Ali Gatie - "Welcome Back " ft. Alessia Cara
Ane Brun - "We Need A Mother"
Anitta - "Me Gusta" ft. Cardi B & Myke Towers
Astrid S - "It's OK If You Forget Me"
Baby Keem - "hooligan"
Baby Keem - "​sons & critics freestyle"
Bino Rideaux - "MISMATCH (Remix)" ft. Young Thug
Blac Chyna, Too $hort & Keak da Sneak - "My Word"
Black Honey - "Run For Cover"
Bon Jovi & Jennifer Nettles - "Do What You Can"
Brent Faiyaz - "Dead Man Walking"
Brett Eldredge - "When The Party's Over (Live)"
BUNT. - "Crocodile Tears"
Busta Rhymes & Anderson .Paak - "YUUUU"
Charlotte Cardin - "Passive Aggressive"
Chloe Angelides - "Outside My Window"
Christian Rich & Vic Mensa - "NIGHT RIDERS"
Cochise - "Lost It"
COIN - "You Are the Traffic"
Comet Blue - "Swimming In Circles"
crape - "Psycho" ft. Paris Shadows, Bernard Jabs & Sorry X
CUT_ - "Last Night"
Dami Im - "Paper Dragon"
Dava - "Papercut"
Delta Goodrem - "Solid Gold"
Elliphant - "Time Machine"
Eric Bellinger - "Flotus"
Foogiano - "MOLLY (Remix)" ft. DaBaby
Francis and the Lights - "You Still Take Me To the Light" ft.  Caroline Shaw, Chance the Rapper, Bon Iver & Kanye West
Fredo Bang - Second Line
galen tipton - "electric drama"
Gorgon City - "Burning" ft. Evan Giia
Gracy Hopkins & Tayc - "Melody"
Grey - "NICOTINE"
HoodCelebrityy & Kash Doll - "So Pretty"
Hotboii - "Left Lonely"
Hot Chelle Rae - "Come My Way"
Isac Elliot - "Ghost"
ItaloBrothers - "Let Go" ft. Kiesza
IV - "Swimming" ft. Trippie Redd
JAG & Guapdad 4000 - "Pray"
Jahvillani - "Kentucky"
Jah Vinci - "You Alone"
James Hype - "Afraid" ft. Harlee
Jamila Woods​ - "SULA (Hardcover)"
Jordane Tumarinson - "Blague Cosmique / Ténu"
Joseph Black & Luh Kel - "​homesick"
Julian Lamadrid - "Patience"
Justin Bieber - "HOLY" ft.  Chance the Rapper
Kat Dahlia - "Fácil"
Kathleen - "Dark Side of the Moon"
Kid Buu - "Speed Demon"
Kygo & Donna Summer - "Hot Stuff"
Laura Marano - "Can't Help Myself"
LÉON - "Head and Heart on Fire"
LEISURE - "Lonely Nights"
Like Saturn - "Avoiding Burdens"
lilbootycall - "Do or Die" ft. Liana Bank$
Lil Loaded - "Narco"
Lil Poppa - "R.I.P."
Lil Wop - "Off White"
Luke Combs - "Without You"
Lykke Li - "I Will Survive"
Lyric Jones - "Show You How" ft. VIC MENSA
Maggie Lindemann - "GASLIGHT"
Maja Kristina - "Slow Hand"
Mavado - "Clean"
Max George - "Give Yourself To Me"
MaxoKoolin - "Cake" ft. 8percent
Mylène Farmer - "L'âme dans l'eau"
Nevaeh Jolie - "Screwed Up" ft.  A Boogie wit da Hoodie
Nightly - "the car"
Night Lovell - "Alone"
​nothing,nowhere. "​pretend"
Nova Miller - "Girls Like Us"
Now United - "The Weekend's Here"
Olivia O'Brien - "Now"
ORKID - "1morenight"
Parson James - "High Tide, Low Tide"
Pop Smoke - "Mood Swings (Remix)" ft. Lil Tjay & Summer Walker
Promoting Sounds & Tommy Ice - "Church" ft. guardin
Q Da Fool - "Frozen"
RILEY - "BGE"
Rockie Fresh - "Bluffin" ft. Charity
Rockit Gaming - "LOL, Pt. 2 (Heart Throb)"
Rubi Rose - "Pogo" ft. K CAMP
ryster - "MILLI VANILLI"
Sam Smith - "Diamonds"
Sasha Sloan - "Is It Just Me?"
Sevyn Streeter - "HMU"
Smoke DZA, Wiz Khalifa & Curren$y - "Santos Party House" ft. Girl Talk & Big K.R.I.T.
Smoove'L - "Wait A Minute"
Sofi Tukker, Novak & YAX.X - "Emergency"
Sophie Ellis-Bextor - "Crying at the Discotheque"
T-Pain - "Nooks Bells" ft. Jayteehazard & Cardboard Cowboy
Taylor Swift - "Betty (Live from the 2020 Academy of Country Music Awards)"
Tems (NG) - "Damages"
Tomberlin - "Hours"
Tones and I - "Ur So F**kInG cOoL (blackbear remix)"
Tyga - "Money Mouf" ft. YG & Saweetie
Vado, Dre & Dave East - "Blessings"
Virginia to Vegas - "Palm Springs (the way you made me feel)"
Waltzin - "Watching You In The Morning"
Whethan - "Freefall" ft. Oliver Tree
Xavier Omär - "All Our Time" ft. Jae Stephens
XOV - "Scarface"
YFN Lucci - "Wet (Remix)" ft. Mulatto
YNW BSlime - "Just Wait"
Yung Gravy - "Gas Money"
9/19
Dutchavelli - "Bando Diaries (Remix)" ft. ONEFOUR, Kekra, Noizy & DIVINE
GR7FF - "want you back" ft. 916frosty
Jahmiel - "Imperfection"
JT Music - "On the Grind"

9/20
Intence - "Hot Topic"
9/21
Bryson Tiller - "Always Forever"
Mustafa - "Air Forces"
NateWantsToBattle - "Manipulate"
OMB Peezy - "YEAH"
REASON - "The Soul (Pt. 2)"
Spillage Village, Benji. & EARTHGANG - "Hapi"
You Me At Six - "Beautiful Way"
YSN Flow - "No Time For Rollies"
YSN Flow - "OTW"
9/22
Alicia Keys - "Three Hour Drive (A COLORS SHOW)" ft. SiR
Baby Queen - "Pretty Girl Lie"
Bastille - "​survivin"
​boy pablo - "Leave Me Alone!"
Da$H - "Bussin" ft. Rob Vicious
Jean Dawson - "Starface*"
Magdalena Bay - "Woww"
Molly Payton - "How to Have Fun"
Rittz - "Fucked Up Day"
Skillibeng - "YK Dat Guh"
Sylvan Esso - "Free"
Tim Heidecker & Weyes Blood - "Oh How We Drift Away"
TOBi - "Made Me Everything"
Tropico & Rich The Kid - "G Wagon"
Tune-Yards - "nowhere, man."
Vistas - "Comfort"
9/23
Alan Walker & walkender - "Sagave love (Remix)"
Baker Boy - "Better Days" ft. Sampa The Great & Dallas Woods
Blu DeTiger - "Cotton Candy Lemonade"
Bonobo & Totally Enormous Extinct Dinosaurs - "Heartbreak"
Brandon Rogers - "WAA"
Brandy Clark - "Same Devil" ft. Brandi Carlile
Bree Runway - "Little Nokia"
​Comethazine - "We Gone Win"
grandson - "Dirty"
Jaah SLT - "Right Now" ft. Young Nudy
Jharrel Jerome - "For Real" ft. Kemba
Kayzo & Pixel Terror - "Blindside"
Luna Shadows - "malibu bb"
MadeinTYO - "Money Up" ft. Toro y Moi
Marina Kaye - "7 Billion"
Savannah Ré - "Homies"
Scotty McCreery - "You Time"
SSGKobe - "Feelings" ft. Internet Money
Starrah - "Keep Calm"
Unlike Pluto - "Moving Too Quickly"
Willie the Kid - "Egregious"
YG - "Out On Bail"
9/24
Alison Wonderland - "Bad Things"
ARY - "Angels"
Ashton Irwin - "Skinny Skinny"
Call Me Karizma - "Nails"
clipping. - "96 Neve Campbell" ft. Cam & China
​CXLOE - "Heavy"
Ghostemane - "Lazaretto"
Headie One - "Ain't It Different (Remix)" ft.  Stormzy, ONEFOUR & AJ Tracey
Jennifer Lopez & Maluma - "Lonely"
Jennifer Lopez & Maluma - "Pa' Ti"
Kylie Minogue - "Magic"
Kylie Minogue - "Magic (Single Version)"
Melanie Martinez - "The Bakery"
MoStack - "Miss Me" ft. AJ Tracey
Pablo Alborán - "Si Hubieras Querido"
Quin NFN - "First 2"
Royal Blood - "Trouble's Coming"
Ruby Fields - "Pretty Grim"
Shamir - "Other Side"
Sia - "Courage to Change"
The Neighbourhood - "Lost in Translation"
The Shins - "The Great Divide"
9/25
4 Elements - "Best Day Of Our Lives"
$NOT - "Revenge"
Alok & Ilkay Sencan - "Don't Say Goodbye" ft. Tove Lo
Amy Allen - "Heaven"
Amy MacDonald - "Crazy Shade of Blue"
Arizona Zervas - "RIP"
BFB Da Packman - "Fun Time" ft. Wiz Khalifa
BIA - "SAME HANDS" ft. Lil Durk
Birdy - "Island Lights"
​​brakence - "dropout (Remix)" ft. blackbear
Bruce Springsteen - "Ghosts"
Carlie Hanson - "Ego" ft. iann dior
Che Lingo - "Dark Days" ft. Kojey Radical
Chris Stapleton - "Cold"
Church & AP - "Yeahnah"
CJ Fly & Parris Pierce - "Bamboo Tree"
Danielle Bradbery - "Girls In My Hometown"
DeathbyRomy - "Beautiful Mayhem"
Delaney Jane - "On Paper"
Dorian Electra - "Edgelord" ft. Rebecca Black
Eddie Benjamin - "Speechless"
ELIO - "Jackie Onassis"
Emily Weisband - "Dumber"
Eric Bellinger - "One Thing Missing"
First Aid Kit - "Come Give Me Love"
FLETCHER & Kito - "Bitter" ft. Trevor Daniel
Gabbie Hanna - "Call Me Crazy"
Galantis & NGHTMRE - "Tu Tu Tu (That's Why We)" ft. Liam O'Donnell
GLADES - "Crush"
Guy Sebastian - "Love On Display"
Harry Hudson - "Closing Doors" ft. Astrid S
Hope Tala - "All My Girls Like To Fight"
Isaac Dunbar - "miss america"
Jaguar Jonze - "Deadalive"
Jake Miller - "Reset"
June's Diary - "Way Off"
Katelyn Tarver - "Side of My Heart"
Landon Cube - "Lie to Me"
LBS Kee'vin - "Shining" ft. 42 Dugg
Lera Lynn - "Let Me Tell You Something"
Like Saturn - "Blissful Seclusion"
Lil Loaded - "To the Max"
LØLØ - "Dear First Love,"
Louane - "Poésie indécise"
Luh Kel - "All in You"
Lud Foe - "YNS"
Lund - "Red Tide"
Maisie Peters - "Maybe Don't" ft. JP Saxe
Matt Maeson - "Hallucinogenics (Remix)" ft. Lana Del Rey
MC Virgins - "Virgins Club"
Medina - "In And Out Of Love"
Mike Sabath - "Good Energy"
Moon Taxi - "One Step Away"
Moyka - "I Don't Wanna Hold On (Demo)"
Nea & Nio Gracia - "DIABLO"
OBN Dev - "Scam Jesus 2"
OneRepublic - "Wild Life"
Pixies - "Hear Me Out"
Polo G - "Epidemic"
R3HAB & Nina Nesbitt - "Family Values"
Rah Swish - "50 Bars, Pt. 4"
Rare Essence - "Hit the Floor" ft. Snoop Dogg
REASON - "SAUCE" ft. Vince Staples
REI AMI - "MAC & CHEESE"
Rylo Rodriguez - "Hear This"
SAYGRACE - "Used To"
Sheppard - "Brand New"
Swae Lee - "Dance Like No One's Watching"
Tame Impala - "Borderline (Blood Orange Remix)"
Terror Jr - "Would It Make You Feel Better"
The Weeknd - "King of the Fall"
Tiësto - "The Business"
TINI - "Duele" ft. John C
Tokoyo - Sunrise
Travis Scott - "FRANCHISE" ft. Young Thug & M.I.A.
VÉRITÉ - "​i'll take the blame"
Vin Diesel - "Feel Like I Do"
Vybz Kartel - "Don't Stop"
Ward Thomas - "Someday"
YK Osiris - "Money Keep Coming"
YXNG K.A - "IT IS WHAT IT IS (Remix)" ft. J.I the Prince of N.Y & Lil Tjay
Zara Larsson - "WOW (Remix)" ft. Sabrina Carpenter
ZAYN - "Better"
Zolita - "Bedspell"
9/28
Alfie Templeman - "Forever Isn't Long Enough"
Amanda Shires - "The Problem" ft. Jason Isbell
Arrows in Action - "Falling On Purpose"
Bat for Lashes - "We've Only Just Begun"
Laura Veirs - "Another Space and Time"
NateWantsToBattle - "My Name Isn't Mine"
Omar Apollo - "Dos Uno Nueve"
Young T & Bugsey - "Don't Rush (Naika Remix)" ft. Naika

9/29
​beabadoobee - "How Was Your Day?"
Goat Girl - "Sad Cowboy"
Jewel - "You Were Meant for Me (Demo)" ft. Steve Poltz
Jim-E Stack - "Jeanie" ft. Bon Iver
Liam Bailey - "Champion (Remix)" ft. Black Thought
Louis the Child - "Keep Moving"
Louis the Child & TroyBoi - "Fresh Juice"
Melanie C - "Overload"
Miley Cyrus - "Heart of Glass (Live from the iHeartMusic Festival)"
Purity Ring - "Better Off Alone"
Romy - "Lifetime"
SLUMBERJACK - "Poison" ft. Sydnee Carter
Why Don't We - "Fallin"
Woodkid - "Horizons Into Battlegrounds"
Yuno - "Zebra"
9/30
Anna of the North - "Someone Special"
Ari Lennox - "Chocolate Pomegranate"
Demi Lovato - "Still Have Me"
Forest Blakk - "If You Love Her"
Girl Talk & Bas - "Fallin'"
GIVĒON - "Stuck on You"
Internet Money, Don Toliver & Roddy Ricch - "Lemonade (Remix)"
JIMMY EDGAR - "GET UP" ft. Danny Brown
JIMMY EDGAR & SOPHIE - "METAL"
Jónsi - "Salt Licorice" ft. Robyn
Lil Darkie - "BATSHIT"
Meg Myers - "Any Way You Wanna Love"
MISSIO - "Vagabond" ft. Esoteric
Now United - "Somebody"
​phem - "​stfu"
Steve Aoki & Timmy Trumpet - "Tarantino" ft. STARX
Unlike Pluto - "Addict"2Embed What About Us - Acoustic What About Us (Acoustic) Thomas Daniel acoustic