2 ContributorsNew Music Friday 05/01/20 LyricsDrake - Pain 1993 (with Playboi Carti)
Marshmello - Be Kind (with Halsey)
Megan Thee Stallion -â€…Savageâ€…Remix (feat. BeyoncÃ©)
Lilâ€…Baby - We Paid (feat. 42â€…Dugg)
Future - D4L
G-Eazy - Moana
HAIM - I Know Alone
BRONSON -âŸHEARTâŸATTACKâŸ(feat. lau.ra)
Lil UziâŸVert - Sasuke
24kGoldnâŸ- Unbelievable (feat. Kaash Paige)
Kehlani - F&MU
Doja Cat - Say So (feat. Nicki Minaj)
H.E.R. - Wrong Places (from Songland)
Glass Animals - Dreamland
Machine Gun Kelly - Bloody Valentine
Lil Tjay - Ice Cold
Lil Durk - Viral Moment
Dashboard Confessional - Circles - Recorded at Electric Lady Studios NYC, 2020
Mishaal - Friends (feat. Powfu)
JoJo - Comeback (feat. Tory Lanez and 30 Roc)
[Tora - Call Your Name]ğŸš
Oliver Malcolm - Kevin
French Montana - Cold (feat. Tory Lanez)
boylife - bummy!
boyband - realtree
Quinn XCII - Coffee
Kenny Chesney - Happy Does
Dixie Chicks - Julianna Calm Down
Kevin Gates - Still Hold Up
Imanbek - I'm Just Feelinâ€™ (Du Du Du)
Anson Seabra - Hindenburg Lover
Lukas Graham - Love Songs
Banda Sinaloense MS de Sergio LizÃ¡rraga - QuÃ© MaldiciÃ³n
Brandy - Baby Mama
Trey Songz - Back Home (feat. Summer Walker)
Remi Wolf - Photo ID
Peach Tree Rascals - not ok
Destiny Rogers - Kickin' Pushin'
GASHI - Butterflies
Evie Irie - Worst Enemy
Noah Kahan - A Troubled Mind
Gabby Barrett - Got Me (feat. Shane & Shane)
Turbo - Heart Stop
Tee Grizzley - I Spy
Smooveâ€™L - Outstanding
YG - Laugh Now Kry Later!
Aluna - Body Pump
Lav - Wavvy
Paloma Mami - Goteo
Milky Chance - Don't Let Me Down
Mt. Joy - Death
Car Seat Headrest - Famous
[Christian Alexander - Growing Up]ğŸš
Amber Mark - 1894
Kota the Friend - B.Q.E
Kid Ink - Live Forever
O.T. Genasis - I Look Good
[Hit-Boy - Nominated]ğŸš
Seeb - Unfamiliar
Oh Wonder - I Like It When You Love Me
Mahalia - BRB
Bruno Major - The Most Beautiful Thing
Luke Combs - Six Feet Apart
Brett Young - Lady
NEEDTOBREATHE - Hang On
BLOXX - Lie Out Loud
[Caleb Peters - Carousel]ğŸš
Salem - It Gets Better
Khruangbin - Time (You and I)
Big Thief - Love in Mine
Lola Young - Same Bed
Lil Loaded - Every Time We Step
Mozzy - Body Count (feat. King Von & G Herbo)
Yung Lean - Pikachu
WizTheMc - For a Minute
Leven Kali - MADE 4 U
Luis Fonsi - Girasoles
Hayden James - Right Time
Larkins - Are We Having Any Fun Yet?
Oasis - Don't Stop... - Demo
Chicano Batman - I Know It
Yellow Days - Treat You Right
Jack Curley - Down
Lori McKenna - When You're My Age (feat. Hillary Lindsey & Liz Rose)
HARDY - BOOTS
VOILÃ€ - If You Were Me
Chaz Cardigan - S.O.S
for KING & COUNTRY - Together
August Wahh - Elated
Doe Boy - Split It (feat. Moneybagg Yo)
Quando Rondo - Sticc to the Code
[Rahli - Lorna Love]ğŸš
Maejor - Issues (432 Hz) (feat. Juicy J)
[Jak Bannon - THE TRADE]ğŸš
Stephen - I Never Stay In Love
Arca - Nonbinary
ADÃ‰ - Replacements
ICECOLDBISHOP - DICKIES SUITEmbed Be Kind (with Halsey) Be Kind (with Halsey) Marshmello;Halsey dance