11 ContributorsApril 2019 Singles Release Calendar Lyrics4/1
Ariana Grande & Victoria Monet - "MONOPOLY"
Bazzi - "Caught in the Fire"
Snoh Aalegra - "You"
SoMo - "Neck"
Young Dolph - "By Mistake (Remix)" ft. Project Pat & Juicy J

4/2
Fredo Bang - "Gangsta Talk" ft. NLE Choppa

4/3
Antony Carle - "Save Face"
Baker Grace - "Handcuffs"
Gallant - "Gentleman (Remix)" ft. T-Pain
Jennifer Lopez & French Montana - "Medicine"
JPEGMAFIA - "The Who" ft. Eyas
Mystery Skulls - "Back To Life"
Parker - "Voices"
ShaqIsDope - "Float Freestyle"
Unlike Pluto - "Brain, Brain, Go Away"

4/4
Alison Wonderland - "Peace"
Anderson .Paak - "Make It Better" ft. Smokey Robinson
Austin Mahone - "Anxious"
Bazzi - "Paradise"
Mariah Carey - "A No No (Shawni Remix)" ft. Shawni
Party Favor - "Dreams" ft. KingJet
Prod3am - "1183"
ScHoolboy Q - "CHopstix"
The Vamps - "Right Now" ft. Krept & Konan
Vampire Weekend - "This Life"
Vampire Weekend - "Unbearably White"
4/5
Anitta & Swae Lee - "Poquito"
Anouk - "It's A New Day"
AJR - "Dear Winter"
AURORA - "The Seed"
Cheat Codes - "Be the One" ft. Kaskade
Cheeks Bossman - "UDIGG"
Conchita Wurst - "See Me Now"
CYN - "Terrible Ideas"
​dePresno - "Wanderers"
Famous Dex - "Rockstar Lifestyle"
galen tipton - "scream"
Gia Woods - "Keep On Coming"
Haviah Mighty - "Wishy Washy" ft.  Omega Mighty
Jack Curley - "Alice"
Jonas Brothers - "Cool"
Karol G - "Punto G"
Kevin Rudolf - "I Will Not Break" ft. Lil Wayne
Khalid - "Don't Pretend" ft. SAFE
Khalid & John Mayer - "Outta My Head"
Labrinth - "SIN (DEMO)"
Leon Else - "Change Up"
Lil Nas X - “Old Town Road (Remix)” ft. Billy Ray Cyrus
Loren Gray - "Options"
Loren Gray - "Lie Like That"
MAX - "Love Me Less" ft. Quinn XCII
Michael Calfan - "My Place" ft. Ebenezer
MOTi - "Sink Deeper" ft. Icona Pop
Noname - "Song 32"
Ollie - "Leave Me Alone"
Paloma Faith - "I've Gotta Be Me"
Parachute - "Ocean"
Pivot Gang - "Bad Boys" ft. Joseph Chilliams, Saba, MFnMelo & Smino
R3HAB - "All Around The World (La La La)" ft. A Touch of Class
RiFF RAFF - "JODY HiGHROLLER QUARTER MiLL EVERY NIGHT" ft. J-Dawg
Rita Ora - "Only Want You (Sam Feldt Remix)"
Ryan Caraveo - "Deceived"
SAFE - "Paid In Full" ft. Playboi Carti
​The Lumineers - "Gloria"
Tokio Hotel - "When It Rains It Pours"
Tom Odell - "Summer Day"
Tulisa - "Daddy"
Yuna - "Forevermore"
Yung Gravy - "Magic"
4/6
ohtrapstar - "Pedigree"
Luigi 21 Plus - "Siempre Papi, Nunca Inpapi" ft. J Balvin
LEX - "Tipota Ston Kosmo"
4/7
Keith Urban - "Burden"
Pixie Lott - "Sunflower"
Teairra Marí - "I Ain't Got It"
4/8
Cage The Elephant - "Goodbye"
Courtney Barnett - "Everybody Here Hates You"
GASHI - "My Year (Remix)" ft. Soulja Boy Tell 'Em
lil keyu - "Slide"
Lil Uzi Vert - "Sanguine Paradise"
4/9
Cixqo - “Money”
Chief Keef - "Boost"
DP Beats - "Lucky" ft. Chief Keef
Jessie Reyez & 6LACK - "Imported"
LAMB$ - "BREAK YA BACK" ft. Ski Mask the Slump God
Lil Uzi Vert - "That's a Rack"
Steve Lacy - "N Side"
Yung Trench - "Green Tractor"
4/10
Anna of the North - "Used to Be"
Avicii - "SOS" ft. Aloe Blacc
KAYTRANADA - "DYSFUNCTIONAL" ft. VanJess
Lil Nas X - "Sonic Shit"
Lil Uzi Vert - That's a Rack"
Pollàri - "VISINE!!!!!"
Snow Tha Product - "Say Bitch"
4/11
Benzi - "Whatcha Gon Do" ft. Bhad Bhabie, 24hrs & Rich the Kid
Chris Brown - "Back to Love"
Country Greg - "Old Town Road (Remix)"
Landon Cube - "Make Up"
Lil Peep - "Gym Class"
NLE Choppa - "Birdboy"
P!nk - "Can We Pretend" ft. Cash Cash
Ronny J - "STAR"
Sech - "Qué Más Pues (Remix)" ft. Farruko, Maluma, Nicky Jam, Lenny Tavárez, Dalex & Justin Quiles

4/12
070 Shake - "Morrow"
070 Shake - "Nice to Have"
Anitta - "Ugly (English Version﻿)"
Anitta - "Ugly (Fea) [Spanish Version]"
Asher Angel - "One Thought Away" ft. Wiz Khalifa
Beast Coast - "Coast/Clear" ft. Nyck Caution, Issa Gold, Kirk Knight, Flatbush Zombies & Joey Bada$$
blackbear - "DEAD TO ME"
BEXEY - "HOT STEPPA"
Cal Chuchesta - "Best Teef? (Anderson .Paak Diss)" ft. Anthony Fantano
Ellie Goulding - "Sixteen"
Emma Blackery - "Cute Without You"
GANZ - "Carry Me" ft. Jantine
Geko x French Montana x Ay Em - "New Money"
Intellexual - "Shotty" ft. Sophia Black & Vic Mensa
Jesse y Joy & J Balvin - "Mañana es Too Late"
Jessica Mauboy - "Sunday"
Khalid, Megan Thee Stallion & Yo Gotti - "Talk (REMIX)"
Kygo - "Think About You (Galantis Remix)"
Laura Marano - "A Little Closer"
Mark Ronson - "Late Night Feelings" ft. Lykke Li
Mike Perry, Dimitri Vangelis & Wyman & Ten Times - "Changes" ft. The Companions
Oliver Heldens - "Summer Lover" ft. Nile Rodgers & Devin
Oliver Tree - "Fuck"
Plies - "Drip 4 Sale Extravaganza" ft. YoungBoy Never Broke Again & Kevin Gates
PnB Rock - "Go To Mars" ft. Tee Grizzley
Rak-Su - "Yours or Mine"
Rita Ora - "Only Want You (Martin Jensen Remix)"
Seeb & Highasakite - "Free To Go"
Smokepurpp - "Remember Me"
Tame Impala - "Borderline"
Tyler Ward - "Plans in Pencil"
Vanic - "Forever Down" ft. wifisfuneral & Saint Sinner
YBN Almighty Jay - "God Save Me"
4/13
Domo Wilson - "Bisexual Anthem"
4/14
J Hus - "Daily Duppy" ft. GRM Daily

4/15
Beck - "Saw Lightning"
Dominic Fike - "PIMPIN'"
Tyga - "Goddamn"
4/16
Smokepurpp - "Repeat"
4/17
24hrs - "Back Out" ft. Ty Dolla $ign & Dom Kennedy
Christian Paul - "Strong"
J-E-T-S - "REAL TRUTH" ft. Tkay Maidza
Madonna & Maluma - "Medellín"
Warhol.ss - "Lira Galore"
4/18
Akachi - "Super Fly" ft. Famous Dex, Pachino
Chris Brown - "Wobble Up" ft. Nicki Minaj & G-Eazy
dnny - "way wrong" ft. XUITCASECITY
EMI - "Used 2 Be"
Flipp Dinero - "Not Too Many"
French Montana - "Slide" ft. Lil TJay & Blueface
Injury Reserve - "Koruna & Lime"
lilbootycall - "MARIAH"
No Rome - "Cashmoney"
SZA, The Weeknd & Travis Scott - "Power Is Power"
Tee Grizzley - "God's Warrior"
4/19
24hrs - "Back Out" ft. Dom Kennedy & Ty Dolla $ign
Allisa Rose - "All to Me"
Alyson Swift, Princess, Ryanning - "Level 7"
Au/Ra - "Assassin"
Becky G & Maluma - "La Respuesta"
BrownBoi Maj - "Chico" ft. Kap G & Wiz Khalifa
Carly Rae Jepsen - "Julien"
Daddy Yankee & Katy Perry - "Con Calma (Remix)" ft. Snow
Era Istrefi - "Nuk E Di" ft. Nora Estrefi
Flipp Dinero - "If I Tell You"
Great Good Fine OK - "Terrified" ft. Pell
Jeremy Zucker & Chelsea Cutler - "you were good to me"
Jordyn Jones - "think about u"
Josh A & Jake Hill - “Heartbreaks"
Kygo & Rita Ora - "Carry On"
Lil Dicky - "Earth"
Lil Peep - "Star Shopping"
Loyle Carner & Tom Misch - "Angel"
Mary J. Blige - "Stay With Me"
Matisse & Sadko & Robert Falcon - "Another Side" ft. Wrabel
Octavian - "Lit" ft. A$AP Ferg
Offset & Lost God - "Power Moves"
Olivia O'Brien - "Just a Boy"
OMB Peezy - "One Me" ft. Sada Baby
Pedro Capó & Farruko - "Calma (Alicia Remix)" ft. Alicia Keys
Shay Lia - "Dangerous"
Sheryl Crow & Johnny Cash - "Redemption Day"
Snugs - "Heart In The Headlights" ft. SayWeCanFly
Sophia Scott - "Drink Too Much Wine"
Steve Aoki & Alok - "Do It Again"
Sultan + Shepard & Showtek - "We Found Love"
SVDDEN DEATH - "Ichor" ft. Ace Savage
Tara Carosielli - "Your Nerves"
The Boyboy West Coast - "U Was At The Club (Bottoms Up)"
Thomas Rhett - "Remember You Young"
Two Friends - "Dollar Menu" ft. Dani Poppitt
Valee - "You & Me Both"
Violet Skies - "Give Me a Reason"
Why Don't We - "Don't Change"
X Ambassadors - "HEY CHILD"
Yaeger - "I Don't Even Know What I'm Saying"
4/20
Berner - "Get Rich or Die Smokin"
IRIS - "Why Do We Hold (Resurrection)"
Jim Jones - "4/20" ft. Wiz Khalifa & Curren$y
Neon Hitch - "Weakness"
4/21
B.o.B - "Soul Glo"
Florence + The Machine - "Jenny of Oldstones (Game of Thrones)"
Ruelle - "The World We Made"
4/22
G Flip - "I Am Not Afraid"
P!nk - "Hurts 2B Human" ft. Khalid

4/23
Beyoncé - "SORRY (Original Demo)"
DUCKWRTH - "LOVE IS LIKE A MOSHPIT" ft. Rico Nasty & Medasin
Flying Lotus - "Spontaneous" ft. Little Dragon
MEDASIN & Rico Nasty
Josh A & Jake Hill - “With You”
Jordan Rakei - "Say Something"
LANY & Julia Michaels - "​okay"
4/24
Bishop Nehru - "The Perfect Gift"
Diplo & Cam - "So Long"
DJ Snake & Sheck Wes - "Enzo" ft. Gucci Mane, 21 Savage & Offset
EDEN - "909"
FKA twigs - "Cellophane"
Lil Tracy & Lil Kawaii - "I Love My Fans"
Luis Fonsi, Nicky Jam & Sebastián Yatra - "Date La Vuelta"
Mannequin Pussy - "Drunk II"
NIKI - "​lowkey"
Party Favor - "Wait A Minute" ft. A$AP Ferg & Juicy J
Red Velvet - "Power Up (Japanese Ver.)"
Russ - "All I Want" ft. Davido
ScHoolboy Q - "CrasH"
Sum 41 - "Out for Blood"
Two Door Cinema Club - "Satellite (Single Edit)"
Unlike Pluto - "Sin Circus"
YG - "Stop Snitchin"
Young Nudy & Pi'erre Bourne - "Mister" ft. 21 Savage

4/25
AD, AzChike, & Sorry Jaynari - "Bruce Lee"
Bastille - "Doom Days"
C. Tangana - "Para Repartir" ft. Alizzz
Kim Petras - "Broken"
Lauv - "Drugs & The Internet"
Lil Keed - "Oh My God"
Marshmello, Tyga & Chris Brown - "Light It Up"
Martin Garrix - "Summer Days" ft. Macklemore & Patrick Stump
Ozuna - "Baila Baila Baila (Remix)" ft. Daddy Yankee, J Balvin, Farruko & Anuel AA
Supreme Patty - "Old Town Road (Remix)"
4/26
Aly & AJ - "Don't Go Changing"
Becky G & Digital Farm Animals - "Next to You" ft. Rvssian
Betta Lemme - "Play"
Big Data - "Put Me to Work"
Birdman - "Cap Talk" ft. YoungBoy Never Broke Again
BJ the Chicago Kid - "Time Today"
Carlie Hanson - "Back in My Arms"
changing cleo - "poison ivy"
Chaz French - "Handful" ft. Rich the Kid
DillanPonders - "GO TIME"
Diplo - "Win Win" ft. Tove Lo
Don Diablo & Jessie J - "Brave"
Felix Jaehn & Breaking Beattz - "LIITA"
FLETCHER - "If You're Gonna Lie"
FRENSHIP - "Keep You Close"
​ionnalee - "SOME BODY"
Jim Jones - "Mama I Made It" ft. Cam'ron
JUMEX - “WISH ME DEATH”
Lotus & Gravy - "The Power of Love (Miura Keys Main Mix)" ft. Nicki Minaj
Lucky Daye - "Love You Too Much"
Lud Foe & Lil Uzi Vert - "Show U Off"
Matt Fax - "Universal"
Monica - "Me + You"
Pitbull, Daddy Yankee & Natti Natasha - "No Lo Trates"
PRETTYMUCH - "Phases"
QM Steezy - "That Weed Walk Corny"
Quinn Lewis - "Only Everything"
Rymez & Stefflon Don - "Don Walk"
Sean Kingston - "Peace of Mind" ft. Davido & Tory Lanez
SHY Martin - "Out of My Hands"
Sofia Karlberg - "Stockholm Syndrome"
Stormzy - "Vossi Bop"
Taylor Swift - "ME!" ft. Brendon Urie
Terror Jr - "Loved By You"
The Black Keys - "Eagle Birds"
The Chainsmokers, Ty Dolla $ign & bülow - "Do You Mean"
Tritonal & Evalyn - "Real"
Zara Larsson - "WOW"
4/27
A Boogie wit da Hoodie - "Embarrass"
4/29
Banks - "Gimme"
KILL.ZERO - "endless,.."
Sizzy Rocket - "DANG"
Sophie Anderson - "Driving for Dick (Remix)"
The Manor - "The Lottery"
4/30
Angels & Airwaves - "Rebel Girl"
Ari Lennox - "Up Late"
Burns - "Energy" ft. A$AP Rocky and Sabrina Claudio
Die Antwoord - "DntTakeMe4aPoes"
EMI - "Jekyll/Hyde"
Leven Kali - "Mad At U"
Mozzy - "Killdrummy"
Thouxanbanfauni - "Interstellar"Embed SOS SOS (feat. Aloe Blacc) Avicii;Aloe Blacc edm