10 ContributorsApril 2021 Singles Release Calendar Lyrics4/1
BTS - "Film out"
​chloe moriondo - "I Eat Boys"
Danny Elfman - "Kick Me (Zach Hill Remix)"
Dayglow - "Woah Man"
Jacquees - "Trackstar (QueMix)"
Keith Ape - "I Don't Want Peace"
Keith Ape - "I'm JUST"
Kody Lavigne - "no i'm not okay"
kuru - "skytearer" ft. blackwinterwells
Lil Gotit - "Toosie"
Litany & Oscar Scheller - "Playlist"
Mat Kearney - "Anywhere With You"
MOL$ - "スウキ ベイビー"
Olivia Rodrigo - "deja vu"
Oscar and the Wolf - "James"
Ozuna & Ovi - "Envidioso"
Shotgun Willy & Yung Craka - "Respected Man"
St. Vincent - "The Melting of the Sun"
The Voidz - "The Eternal Tao 2.0"
yvngxchris - "april fools"
4/2
27CLUB - "THERAPY"
42 Dugg & Roddy Ricch - "4 Da Gang"
Amber Van Day & ILIRA - "See You in Tears"
Bailey Bryan - "Temporary"
Benny the Butcher & Ransom - "Spineless"
BROCKHAMPTON - "COUNT ON ME"
CAL - "In The Water"
Cami Petyn - "Tired"
Chiiild & Mahalia - "Awake"
CMTEN - "MUSIC BOX"
Desiigner - "I Get That"
Don Diablo - "Eyes Closed"
Dove Cameron - "LazyBaby"
Dro Kenji - "Superstar"
Freddie Gibbs - "Big Boss Rabbit"
Fredo Bang - "Click Up"
Futuristic & Michael Minelli - "Bad Decisions"
FXXXXY - "Yeah Kool" ft. Lil Uzi Vert
GLADES - "Limbo"
HAERTS - "Why Only You"
Iggy Azalea - "Brazil"
Iggy Azalea & Tyga - "Sip It"
Ina Wroldsen - "Matters"
Jehry Robinson - "Out My Face" ft. Tech N9ne
Jutes - "Delete My Number"
Kenny Mason - "RIH"
Kevin Gates - "Back In Blood (Freestyle)"
Lil Gnar - "Not the Same" ft. Lil Skies
LocateEmilio - "Crash"
Malia Civetz - "Anybody but You"
MO3 - "Mob" ft. Foogiano
​morgxn - "Porcelain"
Muwop & King Von - "Nobody Move"
NERVO - "Pickle" ft. Paris Hilton & Tinie Tempah
No Dice - "Peter Griffin"
NUT!!! - "DOOKIE" ft. Yung Craka
Olivia Holt - "love on you."
Pi’erre Bourne - "4U"
REI AMI - "THAT'S ON YOU!"
Rochelle Jordan - "Something"
Saweetie - Best Friend (Jamie & CHANMINA Remix) ft. CHANMINA, JAMIE & Doja Cat
Shy Glizzy & No Savage - "Ridiculous"
Snoop Dogg - "Roaches In My Ashtray" ft. ProHoeZak
Sunni Colón - "Provide"
Steele 11 & Rio Leyva - "SWITCH UP"
Tana Rose - "I Can Feel The Rush"
Tommy Cash - "Zuccenberg" ft. Diplo & $UICIDEBOY$
Tom Odell - "monster, vol. 2"
TRAQULA, Billy Marchiafava & MOL$ - "Don't Waste My Time"
Xan Griffin - "Do It by Myself"
Young M.A - "Successful"
Yungeen Ace - "Opp  Boyz"
Zolita - "Bedspell (Remix)" ft. Kailee Morgue
4/3
StaySolidRocky - "Tragic"
4/4
Kodak Black - "Easter in Miami"
Since99 & BasedNas - "See Me"
Weyes Blood - "Titanic Risen"
4/5
SupaFreakLove, Thitis - Get Some

4/6
Bebe Rexha - "Sacrifice (Niiko x SWAE Remix)"
Billie Marten - "Creature of Mine"
CHANYEOL - "Tomorrow"
Holly Humberstone - "Haunted House"
Lil Tecca - "Show Me Up"
Rostam - "Changephobia"
Sinead O'Brien - "Kid Stuff"
Steve Aoki & Kiiara - "Used to Be (Acoustic)" ft. Rob Thomas
Sufjan Stevens - "Meditation V"
Texas - "Mr Haze"
Tierra Whack - "Link"
4/7
Anderson East - "Madelyn"
Belly - "IYKYK"
Belly - "Money on the Table" ft. Benny the Butcher
Franc Moody - "Big Cheese"
GRAE - "Spinning"
Gus Dapperton - "Palms (Remix)" ft. Channel Tres
Lydia Ainsworth - "Sparkles & Debris"
M24 - "Plugged In (Freestyle)"
Mae Muller - "Gone"
NIZIU - "Take a Picture / Poppin' Shakin'"
Now United - "Fiesta"
OSTON - "I Think You Should Leave"
Overcoats - "The Hardest Part" ft. Tennis
Paul Mccartney & Ed O'Brien - "Slidin' (EOB Remix)"
renforshort - "exception"
Rick Astley - "Unwanted"
Róisín Murphy - "Assimilation"
​slenderbodies - "heartbeat"
Taylor Swift - "Mr. Perfectly Fine (Taylor's Version) [From the Vault]"
Ten Tonnes - "Everything You Got"
Tkay Maidza - "Syrup"
Tommy Ice - "okay" ft. 637godwin
twenty one pilots - "Shy Away"
Xanman - "Goosebumps"
Yung Mal - "Belaire"
4/8
$NOT - "Whipski" ft. Lil Skies & Internet Money
Alice Merton - "Vertigo"
ARY - "Hurt You" ft. Emilie Nicolas
Ashe - "I'm Fine"
boyband - "fooly cooly"
Brandon Kai - "Dolce"
Casanova - "Outside" ft. Quavo
Deno - "Lingo" ft. J.I the Prince of N.Y & Chunkz
Dounia - "Lavender"
El Alfa, CJ & Chael - "La Mamá de la Mamá" ft. El Cherry Scom
Gatlin - "What If I Love You"
Good Times Ahead - "So Good"
Icewear Vezzo - "Up the Sco" ft. Lil Durk
J Balvin & Khalid - "Otra Noche Sin Ti"
Juanes - "El Amor Después del Amor"
Kida Kudz - "Animalistic"
KIRBY - "Boyz II Men"
Lil Eazzyy - "Hunnid or Better" ft. Bizzy Banks
London Grammar - "America"
Of Monsters and Men - "Destroyer"
Pouya - "Leave Me Alone"
Prince - "Welcome 2 America"
Queen Naija & Ari Lennox - "Set Him Up"
Sematary - "CRUCIFIXION"
SL & M1llionz - "Versus"
Sofi de la Torre - "Y Duele (Remix)" ft. Pablo Alborán
SypSki - "Down & Out (Remix)" ft. Landon Cube & raspy
Tate228 - "JIVE"
Tyler Shaw - "North Star"
Years & Years - "Starstruck"
Zoey Dollaz - "Broad Day Light"
4/9
2KBABY - "Ohio River"
A.CHAL - "TAPPD'N"
A.G. Cook - "Beautiful Superstar (EASYFUN Remix)"
AJ Mitchell - "STOP"
AK - "No Games"
Aly & AJ - "Symptom of Your Touch"
Armin van Buuren - "Weight of the World" ft. RBVLN
Ar'mon & Trey - "Take the Blame" ft. Lil Tjay
Bebe Rexha - "Sacrifice (Gorgon City Remix)"
BigKayBeezy - "Walk Down" ft. Pooh Shiesty
Bladee & Mechatok - "Grace (Salem Remix)"
Centimillimental - "青春の演舞"
Charlotte Cardin - "Sad Girl"
Col3trane - "Whatchumacallit"
Conway the Machine​ - "Blood Roses" ft. Jae Skeese
cupcakKe - "Mickey"
DMX, Bootsy Collins, & Steve Howe - "X Moves" ft. Ian Paice
Doja Cat - "Kiss Me More" ft. SZA
Flight - "BTFU"
Florrie - "Walk Away"
Forest Blakk - "If You Love Her (Remix)" ft. Meghan Trainor
Gabrielle (NO) - "det urolige hjertet"
Global AzN - "Overdrive"
Gorillaz - "Gorillaz (Gorillaz 20 Mix)"
GRACEY & Billen Ted - "Got You Covered"
Gwen Stefani & Saweetie - "Slow Clap (Remix)"
Imanbek, Sean Paul & Sofía Reyes - "Dancing on Dangerous"
ILLENIUM & iann dior - "First Time (Same Feldt Remix)"
Isac Elliot - "Roommates"
James Vincent McMorrow - "Waiting"
Joey Trap - "PROFESSIONAL"
Jordan Knows, Thekidszn & Brandon ThaKidd - "So Wrong"
Jutes - "Hummingbird"
Kat Cunning - "Could Be Good"
KyleYouMadeThat - "All About Cake" ft. Kaash Paige & Coi Leray
Like Saturn - "i think i'll be alright"
lilbubblegum - "billie eilish" ft. ciscaux
Llusion & salem ilese - "Yoga"
Majid Jordan - "Waves of Blue"
Matt Ox - "Distorted"
Matthew Tuck & 916frosty - "Someone Like You" ft. Global AzN
Midnight Kids - "Out of Time" ft. Yueku
Money Mu - "Problem" ft. Pooh Shiesty
Nathan Dawe, Anne-Marie & Mostack - "Way Too Long"
Night Lovell - "​Bottom Top"
Olivia O'Brien - "Sociopath"
Peter Rosenberg & Westside Gunn - "Stain"
Polo G - "RAPSTAR"
ppcocaine - "Level Up"
PRAX & Tom Riddle - "ETHANOL (Tom Riddle Remix)" ft. 916frosty
Quinn Lewis - "Don't Love Back"
R3HAB & Andy Grammer - "Closer to You"
Rag'n'Bone Man & P!nk - "Anywhere Away From Here"
Ritt Momney & Claud - "Set the Table"
scarlxrd - "DXING ME."
SHAED - "Osaka"
SHY Martin - "Remember You Were the One"
Slayyyter - "Cowboys"
Sonder & Jorja Smith - "Nobody But You"
SpotEmGottem & NLE Choppa - "Beat Box 4"
Surf - "jack in a box"
Surfaces - "Wave of You"
Tim McGraw - "God Moves the Pen"
Trippie Redd & SOS LO - "Honorable Flex" ft. Chris King
Veronica Fusaro - "Fool"
Westsidejhitt - "Whateva It Takez" ft. Quin NFN
YRN Murk - "Get Back" ft. Offset
ZillaKami & Lil Uzi Vert - "BADASS"
4/10
BEXEY - "MONTERO (CALL ME BY YOUR NAME) LIL NAS X FREESTYLE"
Dave - "Mercury"
Dave - "Titanium"
Now United - "Fiesta"
Yung Dastard - "2much! (Remix)" ft. yvngxchris

4/11
Mace Syre - "Shadowed Glass" ft. 916frosty

4/12
Miles Wesley - "Mary Jane Interlude"
4/13
Carlos Vives & Ricky Martin - "Canción Bonita"
Easy Life - "skeletons"
Erika de Casier - "Polite"
Fickle Friends - "Cosmic Coming of Age"
Greentea Peng - "Kali V2"
Guwop Reign - "Forgot It"
IDER - "Cross Yourself"
Lucy Dacus - "Hot & Heavy"
Maple Glider - "Swimming"
Mick Jagger - "Eazy Sleazy" ft. Dave Grohl
Orla Gartland - "Zombie!"
Qveen Herby - "Juice"
Royal Blood - "Boilermaker"
Thomas Rhett - "Country Again"
Tommy Newport & EARTHGANG - "Stargazer"
4/14
Baby Queen - "Dover Beach"
BabyJake - "Do I Fit in Your Shoes?"
Charli Adams - "Cheer Captain"
Conway the Machine - "Scatter Brain" ft. JID & Ludacris
Dawn Richard - "Mornin' / Streetlights"
Dizzy - "The Bird Behind the Drapes" ft. Luna Li
Emotional Oranges & Becky G - "Down to Miami"
Exit Kid - "Munny"
girl in red - "You Stupid Bitch"
Imelda May - "Diamonds"
Inugami Korone - "SAIKYO TENSAI WANDERFUL WORLD of KORONE"
Jacquees - "No More Parties (QueMix)" ft. Erica Banks
James Vickery - "Hourglass"
KIRINJI - "Saikai"
KUČKA - "Eternity"
LAUREL - "You're the One"
Liz Phair - "Spanish Doors"
MARINA - "Purge the Poison"
MISSIO - "Losing My Mind (Stripped)"
Moneybagg Yo - "GO!" ft. BIG30
Oscar Lang - "Stuck"
Ralph - "Tommy"
Real Lies - "Late Arcades"
Rina Sawayama & Elton John - "Chosen Family (Remix)"
Sinéad Harnett - "Hard 4 Me 2 Love You"
Tirzah - "Send Me"
Token - "Dentures"
Unlike Pluto - "Fallen Parachutes"

4/15
Anaiis - "juno"
Ashley Kutcher - "If I Could"
Baker Grace - "I Feel for You"
Cautious Clay - "Karma & Friends"
Charlotte OC - "Bad Bitch"
Charlotte OC - "Forest"
COIN - "How It Feels"
daine - "boys wanna txt" ft. ericdoa
Gaspard Augé - "Force Majeure"
JAWNY - "Best Thing"
Julia Michaels - "Love is Weird"
Julian Lamadrid - "15 Minutes"
Keyon Christ - "Black Skin Machine"
Niko Walters - "Not My Neighbour (Remix)" ft. Kiana Ledé
Tawobi, Lord Trippy & Ethereal - "Face"
The Black Keys - "Crawling Kingsnake"
The Coral - "Vacancy"
VÉRITÉ - "by now"
4/16
1nonly - "Move!" ft. ciscaux & Savage Ga$p
$UICIDEBOY$ - "NEW PROFILE PIC"
Alanis Morissette - "I Miss the Band"
almost monday - "hailey beebs"
Amy Shark - "Amy Shark"
Andra Day - "Phone Dies"
Annika Wells - "Love Sucks"
Ashley Monroe - "Groove"
AViVA - "UNBREAKABLE"
Big K.R.I.T. - "Pick Up The Pace"
Beach Bunny & Tegan and Sara - "Cloud 9"
Bebe Rexha - "Sabotage"
Benjamin Francis Leftwich - "Oh My God Please"
Biig Piig - "Lavender"
Billy Marchiafava - "Good Feelin'" ft. MC Virgins
Bino Rideaux - "Incredible" ft. Drakeo the Ruler
Birdy - "Second Hand News"
carolesdaughter - "Trailer Trash"
Charlie Collins - "Fuck It"
Chet Faker - "Whatever Tomorrow"
Citizen Queen - "Y"
Clean Bandit - "Higher (VIZE Remix)" ft. iann dior
Conor Maynard - "Crowded Room"
crape - "Screaming Across the Valley" ft. 916frosty
cupcakKe - "Mosh Pit"
Daddex - "Freezing"
Damien Styles - "Condom Song" ft. Sueco
Dappy - "Wounds"
dePresno - "Tokyo"
Derivakat - "Take Aim"
​DJ Chose & Fredo Bang - "H2O"
dodie - "I Kissed Someone (It Wasn’t You)"
Dua Saleh - "Signs"
Eloise - "Intertwined"
Eric Church - "Heart"
EST Gee - "Lick Back"
FCG Heem - "Shinin'"
Feder & UPSAHL - "Let There Be Drums"
Fivio Foreign - "Self Made"
George Cosby - "Lost on You"
Georgia Twinn - "Matty Healy"
Godfather of Harlem - "Been to War" ft. Swizz Beatz, DMX & French Montana
Godfather of Harlem - "Prince Hakeem" ft. ADE & India Shawn
Grace VanderWaal - "Repeat"
Hey Violet - "Problems"
Holy Holy - "How You Been"
​iann dior - "​don't wanna believe"
​iann dior & Trippie Redd - "​shots in the dark"
IDK & Offset - "Shoot My Shot"
ILUKA - "Mess" ft. Lime Cordiale
Isle of You - "Fallback"
Josie Man - "Little Space for Me"
Jutes - "Careful What You Wish For"
K CAMP - "Life Has Changed" ft. PnB Rock
Kayzo, Sullivan King & Papa Roach - "DOMINATION"
Khalil? - "Don't Think"
KILLY - "TRUST NOBODY"
KWAYE - "Runaway"
Kygo - "Gone Are the Days" ft. James Gillespie
Leah Nobel - "The Ones That Make It"
Like Saturn - "neverending road"
Lil Kee - "Fake Shit" ft. 42 Dugg
Lil Poppa - "AM Flights" ft. Toosii
Lil West - "West Side"
Lord Huron - "Long Lost"
LoveLeo & blackwinterwells - "BUZZCUT"
Lucki - "LifestyleBrazy"
Lucki - "No Joke"
Lxandra - "Sabotage"
Maia Wright - "Break Her Heart"
Matilda - "Nervous"
Matilda Mann - "Doomsday"
Matt Ox - "Go Psycho"
Methyl Ethel - "Neon Cheap"
MUST DIE!, Akeos & Skream - "LOL OK"
Olivia Dean - "Be My Own Boyfriend"
Redman - "80 BARZ"
Regard, Troye Sivan & Tate McRae - "You"
Renni Rucci - "Talk"
Rhys Lewis - "Seasons"
Ruth B. - "Situation"
Sabina Ddumba - "Swishers"
San Mei - "I Can't Sleep"
Shakka & GoldLink - "Solo"
Shungudzo - "White Parents"
Smallpools & Neffex - "the answer"
Snoop Dogg - "Say It Witcha Booty" ft. ProHoeZak
Steele 11 & Rio Leyva - "RED HILLZ"
Stella Donnelly - "If I Could Cry (it would feel like this)"
Steve Aoki & Farruko - "Aire"
Sueco - "SOS" ft. Travis Barker
SypSki & The Awkward Public - "Break My Bank"
Tee Grizzley & G Herbo - "Never Bend Never Fold"
The Darcys - "Swerve"
The Struts & Paris Jackson - "Low Key in Love"
The World Famous Tony Williams & Wale - "Everybody Knows"
Thomston - "Magnolia" ft. Zeph
Toosii - "​what it cost"
Twin Shadow - "Alemania"
Xan Griffin - "Let This Go"
YN Jay - "Drunk When I Made This"
Yun Head - "Wasting Time"
Yung Trench - "Rain"
​Zachary Knowles - "dancing in the kitchen"
4/18
Bugzy Malone - "Salvador"
Calboy - "All Night Long"
4/19
Azealia Banks - "Nirvana"
CHVRCHES - "He Said She Said"
EGOVERT - "Step In The Scene Freestyle!"
Jorja Smith - "Gone"
Lil Darkie - "USA" ft. EDDISON
Lil Yachty - "CORTEX"
Maluma - "Rumba (Puro Oro Anthem)"
Tuxx - "Contaminate"
Villagers - "The First Day"
Zoe Wees - "Ghost"
4/20
Angel Olsen - "Alive and Dying (Waving, Smiling)"
Cixqo - "The Ballers Anthem" ft. Mezino
CJ Fly - "Medicine"
Eliza Shaddad - "Heaven"
Ghastly - "THE OG"
Iggy Azalea & Gloria Groove - "Brazil (Remix)"
Natti Natasha & Becky G - "Ram Pam Pam"
Smoke DZA - "No Regrets" ft. DOM KENNEDY
TWICE - "Kura Kura"
Wolf Alice - "Smile"
4/21
aldn & glaive - "what was the last think u said"
Ashe - "When I'm Older"
Deb Never - "Sorry"
Gorgon City - "Tell Me It's True"
Kota the Friend - "Outside"
Lil Gotit - "Burnt N Turnt" ft. NAV
Lil Loaded - "Bag Talk"
Little Simz - "Introvert"
Mellah - "Easy Breezy"
Morcheeba - "Killed Our Love"
Morray - "Trenches"
Pacman da Gunman & Icewear Vezzo - "Did That"
ryster - "Bad Girls Club"
Sports Team - "Happy (God's Own Country)"
Tora - "Why Won't You Wait"
Weezer - "I Need Some of That"
Yung Mal - "1.5 Way Or No Way"
4/22
Amy Allen - "One"
Avelino - "Demons"
Delta Goodrem - "All of My Friends"
Dutchavelli - "Circle The Endz"
Hanne Mjøen - "Hell with You"
John Grant - "Rhetorical Figure"
Renni Rucci & Kevin Gates - "At"
Russ Millions & Tion Wayne - "Body (Remix)"
Lil Peppa & Lil Grillz - "N-Word"
Shaybo - "Broke Boyz" ft. DreamDoll
TobiShyBoy - "Jagged Edge" ft. M1llionz & Unknown T
YG & Mozzy - "Bompton to Oak Park"
Yola - "Diamond Studded Shoes"
4/23
3OH!3 - "LIGHTS DOWN LOW"
3OH!3 - "WASTE IT ON ME"
Aly & AJ - "Don't Need Nothing"
Amber Mark - "Worth It"
Anthony Russo - "anyone (but you)"
Avian Grays - "Crying 'Bout You"
Azizi Gibson - "Xu"
Ben Platt - "Imagine"
BJ the Chicago Kid, PJ Morton & Kenyon Dixon - "Bring It on Home to Me"
Blake Shelton - "Bible Verses"
Brandyn Burnette - "Addicted"
Brett Young - "Not Yet"
Cash Cash - "Ride or Die" ft. Phoebe Ryan
Chelsea Collins - "Hotel Bed" ft. Swae Lee
Chris Lane - "Fill Them Boots"
ciscaux & EGOVERT - "MY BODY IS A BURNING HOUSE AND EVERYTHING INSIDE IS TRYING TO GET OUT"
Cochise - "SANJI"
Crowder - "Milk & Honey"
D Savage - "Lock'd In"
Elliot Lee - "Rubies"
ElyOtto - "SugarCrash! (Remix)" ft. Curtis Waters & Kim Petras
Fivio Foreign - "Unruly"
​flora cash - "Soul Mate"
Funkmaster Flex & CJ - "You Know"
Godfather of Harlem - "Forgot About the Streets" ft. Brillo, Badda TD & Melvoni
Greyson Chance - "Hellboy"
H.E.R. - "Come Through" ft. Chris Brown
Hamzaa - "IN BETWEEN" ft. Miraa May
Henri Purnell​ - "On My Way Home" ft. Joe Cleere
iris - "​to be mine (is to lose your mind)"
Jagwar Twin - "Down to You"
Jess Connelly - "Risk"
JESSIA - "I'm not Pretty (Remix)" ft. Bebe Rexha
Jessie Murph - "Look Who's Cryin' Now"
Joey Trap - "TRAPPIN' AIN'T UNFAIR"
Jordan McGraw - "HER"
Jutes - "California"
K.Flay - "Four Letter Words"
Katy Perry, Luísa Sonza & Bruno Martini - "Cry About It Later (Remix)"
KEY! - "Savage"
Landstrip Chip & Millie Go Lightly - "Wraith"
Lauren Aquilina - "The Knife"
Lexi Jayde - "running in place"
Lil HE77 - "Falling Out of Luvv"
Like Saturn - "what a view"
LION BABE - "Frida Kahlo"
Luh Kel - "F Love"
MAJ - "Peach Crush" ft. TheHxliday
Matt Cooper - "Ain't Met Us Yet"
Max Jury - "Highway Song"
Max Leone - "Untitled"
Melvoni - "GET MONEY" ft. DDG & Tyla Yaweh
Nardo Wick - "Shhh"
Nessly - "Mythbusters"
Patrick Droney - "Talk About That"
push baby - "CRY / TALK ABOUT IT"
Q - "If You Care"
R3HAB, Luis Fonsi & Sean Paul - "Pues"
Reba McEntire - "Somehow You Do"
Rebecca Black - "Personal"
Rezz & deadmau5 - "Hypnocurrency"
Rich the Kid - "Richard Mille Patek"
Roman Alexander - "Between You & Me (Remix)" ft. Ashley Cooke
​salem ilese - "About a Breakup"
Sara Kays - "Backseat Rider"
Sarah Klang - "Love So Cruel"
Sasha Sloan - "When Was It Over?" ft. Sam Hunt
scarlxrd - "MXRBID."
Shift K3Y & Tinashe - "Love Line"
Skott - "Tired" ft. Shylde
SLEEPWALKRS - "Goodnight" ft. JP Cooper
Sol Jay - "ditto"
SosMula - "Criminal"
SpotEmGottem - "Beat Box 5" ft. Polo G
StarBoi3 - "Dick" ft. Doja Cat
Teddy Swims - "Bed on Fire"
The Alchemist - "Nobles" ft. Earl Sweatshirt & Navy Blue
The Chemical Brothers - "The Darkness That You Fear"
The Hunna - "Bad Place"
TheHxliday - "Wit Dat" ft. Polo G
The Veronicas - "Life of the Party" ft. Allday
The Weeknd & Ariana Grande - "Save Your Tears (Remix)"
Thouxanbanfauni, Eva Shaw & CHXPO - "DIAMONDS"
Tom Odell - "​numb (Remix)" ft. Zaia
Torine - "All My Problems (123456)"
Transviolet - "Clean Laundry" ft. DREAMERS
unperfect - "Can't Get Over It, Pt. 1"
Very Abstract - "Never Gonna Lose" ft. lilbubblegum
Whethan - "Warning Signs" ft. Kevin George
Winona Oak - "Old Insecurities"
Wonder & MOL$ - "sno"
YBN Nahmir - "Opp Stoppa (Remix)" ft. Lil Eazzyy
YoungBoy Never Broke Again - "Territorial"
YSN Flow - "Do It Again" ft. Doe Boy
Yung Tory - "Fake Love"
4/24
BEXEY - "GARGOYLE"
Smokepurpp - "MOB"
Rockit Gaming - "It's Me"
4/26
EDDISON - "4u rmx" ft. Lil Darkie
Now United - "Baila"
Shelley FKA DRAM & Summer Walker - "All Pride Aside"
Snow tha Product - "Never Be Me"
STARSET - "INFECTED"
Will Young - "Daniel"
4/27
Faye Webster - "Cheers"
HUNNY - "Xbox Luvr"
KALI - "Do a Bitch (Remix)" ft. Rico Nasty
League Of Legends & Foreign Air - "Starts Right Here" ft. Kenny Mason
Lil Baby & Megan Thee Stallion - "On Me (Remix)"
Molly Burch - "Control"
Mykki Blanco - "Love Me" ft. Jamila Woods & Jay Cue
Phoebe Green - "IDK"
Self Esteem - "I Do This All the Time"
Vistas - "Stuck in Your Head"
WILLOW - "t r a n s p a r e n t s o u l" ft. Travis Barker

4/28
Adam Melchor - "Light Year" ft. Lennon Stella
Allday - "Stolen Cars"
Bladee & Mechatok - "Drama (Remix)" ft. Charli XCX
Call Me Karizma - "Vacuum Boy"
Chiiild - "Gone"
CLOVES - "Nightmare"
Garbage - "No Gods No Masters"
Half Waif - "Swimmer"
Jackboy - "Protecting My Energy"
Jessie Ware - "Please"
Lights - "Beside Myself"
Sally Sossa - "Right My Wrongs (Remix)" ft. Toosii
​spill tab - "Anybody Else"
ZHU & Arctic Lake - "Yours"
4/29
ALLBLACK, G-Eazy & E-40 - "10 Toes"
Billie Eilish - "Your Power"
Burna Boy - "Kilometre"
​contradash - "222pm"
FRVRFRIDAY - "Priceless"
Gavin Turek - "SLIDE" ft. bLAck pARty
Ghostface600 - "Paper Planes"
INNA - "Oh My God"
Lil Skies - "My Baby" ft. Zhavia Ward
M4zi - "cant lose"
​Machine Gun Kelly - "love race" ft. Kellin Quinn
Noel Gallagher's High Flying Birds - "We're on Our Way Now"
Stand Atlantic - "Deathwish" ft. nothing,nowhere.
The Beaches - "Let's Go"
TINI & María Becerra - "Miénteme"
4/30
21 Savage - "Spiral"
A Boogie wit da Hoodie - "Track Star (Remix)" ft. Mooski
Afrojack & David Guetta - "Hero"
Alan Jackson - "Where Her Heart Has Always Been"
Alec Benjamin - "The Way You Felt"
Alfie Templeman - "One More Day" ft. April
Amber Liu - "vegas"
Anitta - "Girl from Rio"
Ayelle - "Options"
BABii - "DRiiFT"
Baby Keem & Travis Scott - "durag activity"
​bbno$ & Diamond Pistols - "​help herself (Remix)" ft. BENEE
Bebe Rexha - "Die for a Man" ft. Lil Uzi Vert
Bow Anderson - "Hate That I Fell in Love with You"
Brynn Cartelli - "If I Could"
Brynn Elliott - "Letter to a Girl"
BVDLVD - "WHAT'S UP?"
Chord Overstreet - "Stone Man"
Chris Lane - "Summer Job Money"
Daniyel - "SOMEBODY"
Daya - "Montana"
dePresno - "Nordnes"
Digital Farm Animals - "Last Night" ft. Harlee
Diplo - "One by One" ft. Andhim & Elderbrook
Elley Duhé - "Kids of the Night"
Emlyn - "change for me"
Empress Of - "One Breath"
Finn Askew - "Cherry Bomb"
FRVRFRIDAY - "Okay" ft. Vory
Godfather of Harlem - "No Bark When I Bite" ft. Rick Ross & Cruel Youth
Gucci Mane - "Shit Crazy" ft. BIG30
Hayley Kiyoko - "Found My Friends"
Hook N Sling, Galantis & Karen Harding - "The Best"
HunnaV & 916frosty - "Robbery" ft. JXVE
ILLENIUM & iann dior - "First Time (Kayzo Remix)"
Ina Wroldsen - "Fires"
Jamie Miller - "Here's Your Perfect"
JayXander - "Stuck in the Burbs"
Josh A - "ANXIOUS" ft. guccihighwaters
Joy Oladokun - "sorry isn't good enough"
Joyner Lucas & Lil Baby - "Ramen & OJ"
June's Diary - "Maniac"
Justine Skye & Rema - "Twisted Fantasy"
Jutes - "Fvck Your Boyfriend"
Kara Marni - "Twisted Fantasy"
Kings of Convenience - "Rocky Trail"
Kriss Kross Amsterdam, Shaggy & Conor Maynard - "Early in the Morning"
KuttemReese - "No Statements" ft. Lil Durk
Kyle Dion - "Purr" ft. Kari Faux
KyleYouMadeThat - "Make You Happy" ft. YB Redencion, Joseph Black & YBN Nahmir
Lauren Jauregui - "Temporary"
LBS Kee’vin - "That’s Life" ft. OMB Peezy
Like Saturn - "mirror with no reflection"
Lil Boom - "ROCKET POWER!"
Lil West - "Date a Star"
Lily Rose - "Overnight Sensation"
Little Mix - "Confetti (Remix)" ft. Saweetie
Lord Huron - "I Lied" ft. Allison Ponthier
Lou Elliotte - "Happy for Me"
Louis the Child & A R I Z O N A - "So What"
LoveLeo - "TUNG TIED" ft. Rico Nasty
mags - "i can't get over you"
Mat Kearney - "Say It Now"
Marc E. Bassy - "Atmosphere"
Marc E. Bassy - "Zone"
Maverick - "My Way" ft. 916frosty
Meek Mill - "Lemon Pepper Freestyle"
Mereba - "Rider"
Mitch James - "Be Somebody"
Mob Rich - "Made to Fall"
NEFFEX - "Are You Ok?"
Nightly - "lover/loner"
NLE Choppa - "Final Warning"
NoCap - "On Purpose"
OBN Jay - "Green Beam"
Olivia Rodrigo & Joshua Bassett - "Even When / The Best Part"
Parson James & JoJo - "Dirty Laundry"
Picture This - "LA House Party"
PnB Rock - "Need Somebody"
Pressa - "Attachments (Remix)" ft. Coi Leray
Projexx - "Bigga League" ft. Bakersteez
Quadeca - "Soul Train"
Quincy - "On Yo Azz!"
Rag'n'Bone Man - "Crossfire"
Rhys - "Over You"
Riley Clemmons - "I'm Not Alone"
Sarah Close - "I Can't Trust Myself"
Scarlet Pleasure - "Somebody Else"
scarlxrd - "HATE ME THEN."
SHAED - "Dizzy"
SIDEPIECE - "Acrobatic"
Shotgun Willy & Yung Craka - "Mexico"
Snøw - "Spilled My Coffee" ft. Rxseboy & Jack Cullen
Sophia Messa - "Breakfast in Bed" ft. Avenue Beat
Sorry X - "Listerine" ft. 916frosty, crape, SypSki & LOSTBOYKURI
Spice - "Go Down Deh" ft. Sean Paul & Shaggy
Steve Aoki & Jungleboi - "Rubble to Gold" ft. Sam Calver
Still Woozy - "Kenny"
Surf - "Autopsy"
Taylor Bennett - "Come Alive" ft. TheHxliday
The Aces - "Don't Freak"
The Band CAMINO - "Sorry Mom"
The Jungle Giants - "Treat You Right"
The Kid LAROI - "WITHOUT YOU (Remix)" ft. Miley Cyrus
The Marías - "Hush"
Tina Arena - "Church"
twenty one pilots - "Choker"
VEDO - "For Me" ft. Jacquees
Warpaint - "Lilys"
Wiktoria - "Need You to Know"
Wrabel - "good"
Yung Baby Tate - "Eenie Meenie"
Yung Bae - "Woman on the Moon" ft. UPSAHL1Embed You're My Angel - Hypnose Remix Edit You're My Angel Styles & Breeze;Hypnose happy