2 ContributorsNew Music Friday 08/28/20 LyricsCalvin Harris - Over Now (with The Weeknd)
BLACKPINK - Ice Cream (with Selena Gomez)
Big Sean - Deep Reverence (feat. Nipsey Hussle)
Ty Dolla $ign - Expensive (feat. Nicki Minaj)
Cordae - Gifted (feat. Roddy Ricch)
Katy Perry - Cry About It Later
Dua Lipa & The Blessed Madonna - Physical (feat. Gwen Stefani) [Mark Ronson Remix] [Mixed]
Internet Money - Blastoff (feat. Juice Wrld & Trippie Redd)
Disclosure - Birthday (feat. Kehlani & Syd)
girl in red - ruе
Giveon - Untitled (How Does It Feel)
rеggie - Southside Fade
Topic - Why Do You Lie To Me (feat. A7S & Lil Baby)
Travis Scott - The Plan - From the Motion Picture "TENET"
Jaden - Falling For You with Justin Bieber
Russ - Take You Back (feat. Kehlani)
YG - Equinox (feat. Day Sulan)
Sasha Sloan - House With No Mirrors
Chris Stapleton - Starting Over
Black Thought - Good Morning (feat. Pusha T, Swizz Beatz & Killer Mike)
Aluna - The Recipe (feat. KAYTRANADA & Rema)
ILLENIUM - Nightlight
A$AP Ferg - No Ceilings (feat. Lil Wayne & Jay Gwuapo)
Octavian - Famous (feat. Gunna & SAINt JHN)
YVS Village - Rugrat (feat ppcocaine)
Surfaces - Sail Away
SAYGRACE - Feel Good
Tiwa Savage - Temptation (feat. Sam Smith)
Rich Brian - DOA
AG Club - Memphis, Pt. 2 (feat. NLE Choppa & A$AP Ferg)
5 Seconds of Summer - Kill My Time
Goth Babe - The Trees
Ricky Reed - Fav Boy (feat. John-Roberts & Alessia Cara)
Maggie Lindemann - Knife Under My Pillow
CNCO - Beso
Lil Tecca - Royal Rumble
Yo Gotti - Stay Ur Distance
Celeste - Little Runaway
Silvana Estrada - Para Siempre
GRACEY - Like That (feat. Alexander 23)
The Smashing Pumpkins - Cyr
Sam Fischer -  People I Don't Know
Keith Urban - Tumbleweed
Teddy Swims - Broke
Clara Mae - Alright (feat. Russel Dickerson)
Olivia Holt - love u again (with R3HAB)
DVBBS - Loyal (feat. Veronica)
Lil Xxel - MNU
BLACKSTARKIDS - BRITNEY BITCH
Wifisfuneral - Take Me Away
Quando Rondo - Shooters & Movers
JoJo - Love Reggae (feat. Tinashe)
Christina Aguilera - Reflection (2020) - From "Mulan"
Nao - Woman (feat. Lianne La Havas)
LU KALA - Love Like
PVRIS - Use Me (feat. 070 Shake)
Caro - Too Far Gone
lovelytheband - love somebody else
The Avett Brothers - Untitled #4
Alanis Morissette - You Oughta Know
Toni Braxton & H.E.R. - Gotta Move On
The LOX - Miss You feat. T-Pain
Lonr. - The End
Payday - Party
Joey Pecoraro - Lightning (feat. Nana Lourdes)
BUNT. - Nights Like That (feat. Georgia Ku)
Rudimental - Come Over (feat. Anne-Marie & Tion Wayne)
The Neighbourhood - Pretty Boy
Robert Glasper - Better Than I Imagined (Feat. H.E.R. & Meshell Ndegeocello)
Toosii - Love Cycle (with Summer Walker)
Gregory Porter - Everything You Touch Is Gold
Black Pumas - I'm Ready
Billy Raffoul - The Ballad of James Howlett
Jazmine Sullivan - Lost One
Mothica - Blue Hour
K/DA, (G)I-DLE, Wolftyla, Bea Miller & League of Legends - THE BADDEST
Leikeli47 - Zoom
Nasty C - Bookoo Bucks (feat. Lil Gotit & Lil Keed)
King Von - How It Go
Jackboy - The World Is Yours
FXXXXY - Paranoia / #1 Stunna
Ghostemane - AI
Seether - Wasteland
NEEDTOBREATHE - Alive
Rence - Strawberry Blonde
LightSkinKeisha - Queen Kong
India Shawn - Movin' On (feat. Anderson .Paak)
_BY.ALEXANDER - STALLING (feat. Tanerélle)
MF DOOM - Coco Mango (FloFilz Remix)
Smoove'L - Chrome No Heart
ELENA ROSE - COCO
The Score - Carry On (feat. AWOLNATION)
Ruston Kelly - In The Blue
Colter Wall - Big Iron
Abby Anderson - We Go Together Like
Samia - Triptych
Jucee Froot - Champion
Problem - NOTHIN (feat. Jack Harlow & Jay Rock)
KenTheMan - IDGAF
Tm88 - War Stories (feat. Calboy & Slatt Zy)
Kidd Keo - DEMONS (feat.  Young M.A)Embed