1 ContributorNew Music Friday 8/27/21 LyricsHalsey - I am not a woman, I'm a god
Kacey Musgraves - justified
Meek Mill - Sharing Locations (feat. Lil Baby & Lil Durk)
Lil Tecca - CHOPPA SHOOT THE LOUDEST (with Chief Keef, feat.Trippie Redd)
Baby Keem - family ties (with Kendrick Lamar)
Selena Gomez - 999 (with Camilo)
OneRepublic - Someday
Belly - Belly, The Weeknd - Die For It (ft. Nas)
WizKid - Anoti
Griff - One Night
BTS - Butter (feat. Megan Thee Stallion)
Joyner Lucas - Dreams Unfold
42 Dugg - Free RIC (feat. Lil Durk)
Nelly - Country Boy Do (feat. Tyler Hubbard)
Alex Isley - At Your Best (You Are Love) - Spotify Singles
Halsey - You asked for this
Caribou - You Can Do It
Becky Hill - My Heart Goes (La Di Da) (feat. Topic)
OHGEESY - Keeper (feat. A Boogie Wit da Hoodie)
Lil Yachty - Solid (feat. SoFaygo)
Westside Gunn - Bash money (feat. Lil Wayne)
J Balvin - Perra
Kim Petras - Future Starts Now
LANY - roll over, baby
Julia Wolf - Falling In Love
Jaden - Still In Love
MASN - Self Sabotage
CHVRCHES - California
Big Red Machine - Birch (feat. Taylor Swift)
Luke Combs - South On Ya
Surf Mesa - Another Life (feat. FLETCHER & Josh Golden)
Liam Payne - Sunshine - From the Motion Picture â€œRonâ€™s Gone Wrongâ€
Burna Boy - Question (feat. Don Jazzy)
Nicky Jam - Magnum
LP Giobbi - Close Your Eyes - Spotify Singles
daine - SALT (feat. Oli Sykes)
EKKSTACY - In Love
Niko Moon - DIAMOND ğŸš
My Morning Jacket - Regularly Scheduled Programming
Ritt Momney - Show Runner 99
mazie - start of the end
Blu DeTiger - Go Bad - From The Netflix Film â€œHeâ€™s All That" ğŸ•’
Destiny Rogers - Simon Say (feat. Flo Milli)
Gorillaz - Jimmy Jimmy (feat. AJ Tracey)
Mon Laferte - Wish You Were Gay - VersiÃ³n en EspaÃ±ol - Spotify Singles
Headie One - 2 Chains
Rotimi - Polaroid (feat. Yung Bleu)
Alan Walker - Don't You Hold Me Down
TSHA - I Know ğŸš
Prentiss - too fast
The Homies - White Lies
Deyaz - Helpless
girlhouse - concussion
merci, mercy - Winnie Crush
Au/Ra - Young Giants
TrÃ© Burt - Carnival Mirror ğŸ•’
Ashley Cooke - Gettin' Somewhere
AREA21 - Lovin' Every Minute
Maria Becerra - Wow Wow (feat. Becky G)
Kash Doll - Single & Happy (feat. Wale & Eric Bellinger)
Chief Keef - Harley Quinn
KSI - Know You (feat. S-X & A1 x J1)
Jasiah - Right Now (feat. Travis Barker)
Adam Melchor - What A Damn Shame
Madi Diaz - History Of A Feeling ğŸ•’
Sigrid - Burning Bridges
Amber Mark - Foreign Things
Boslen - NIGHTFALL (feat. Dro Kenji)
midwxst - All Talk
BLACKSTARKIDS - FIGHT CLUB
Anuel AA - 23 Preguntas
Don Diablo - Hot Air Balloon
Ai Bendr - The Deep
Jonah Kagen - Wish You Did
Yebba - Boomerang
Chelsea Collins - Wake Up At Our Funeral ğŸ•’
Stray Kids - Thunderous
Diane Warren - Seaside ğŸš
Tamera - Strong for Me
Sevyn Streeter - Nasty Girl
GRIP - Momma Told Me!
Babyface Ray - It Ain't My Fault
HONNE - COMING HOME (feat. NIKI)
Indigo De Souza - Pretty Pictures
Men I Trust - Sugar
Camylio - sometimes
Maisie Peters - Elvis Song
Evann McIntosh - TECTONIC PLATES
Eyedress - Body Dysmorphia ğŸš
Teddy Swims - Simple Things ğŸ•’
ELLIANA - everybody else in LA
David Solomon - Dreaming (feat. SMBDY)
Static & Ben El - Bella
Derek Minor - Wins On Me
BBY KODIE - Children
William Shatner - Clouds of Guilt (with Joe Jonas)
GANGGA - This Love Will Never End ğŸ•’
Scruffpuppie - Assignment Song
MUNYA - Cocoa Beach
EZI - Maraschino Love
JoJo Siwa - Dance Through the DayEmbed