1 ContributorNew Music Friday 3/19/21 LyricsPeaches - Justin Bieber
Headshot (feat. Polo G & Fivio Foreign) - Lil Tjay
Tu Veneno - J Balvin
As I Am - Justin Bieber
Try Me - Lil Mosey
Hood Melody (feat. Youngboy Never Broke Again) - DDG
Traumada - Paloma Mami
White Dress - Lana Del Rey
Unstable - Justin Bieber
Obsessed - Addison Rae
Selfish - Nick Jonas
You Belong To Somebody Else - PJ Harding
Moon in the Morning - Adam Melchor
AIN'T GON STOP ME - Monte Booker
Wolves - Kota the Friend
WHEN THE DEVIL CRIES - 347aidan
Cry - Payday
buzzkill - Mothica
Heartless - Live From LA - Roddy Ricch
Plug Talk (fÐµat. 2 Chainz) - Benny The Butcher
Marigold - JÐµlani Aryeh
(L)only Child - salem ilese
Picture Of You - Sara Kays
As a Child - Madeline The Person
To Begin Again - Ingrid Michaelson
Self! - Isaia Huron
i wanna slam my head against the wall - glaive
Youtube2MP3 - AG Club ðŸ•’
Calabasas - ssgkobe
Sydney - Rich Brian
Brass in Pocket - Teddy Geiger
Love Mania - Starrah
Going Dumb - Alesso
Let's Hold Hands (feat. Melanie Faye) - Dreamer Boy
bad to the bone - bbno$
White Lows Off Designer (feat. Lil Durk) - Tee Grizzley
Cuenta - Myke Towers
FREEDOM - Jon Batiste ðŸ•’
Get Sun (feat. Arthur Verocai) - Pocket Size Radio Edit - Hiatus Kaiyote
Last Cigarette - Morgan Wade
Mine Forever - Lord Huron
Story of My Life - Ant Clemons
Chicken Adobo - Guapdad 4000
Designa (Corvette Corvette, Pt. 2) - Popp Hunna
Lumbago - Yeek
Kneepads - MyKey ðŸ•’
we would have some cute kids. - Tai Verdes
Nevermind - Babygirl
I Really Want U To B Here - Wacomo
Ride Or Die (feat. Chilly Gonzales) - Boys Noize ðŸ•’
Rise - Lost Frequencies
No Plans for Love (with Ne-Yo & Kent Jones) - D-Nice ðŸ•’
Butterflies - James TW
Ruin My Make Up - Lola Young ðŸ•’
Big Facts - Kareen Lomax
Judas - Bad Gyal
Sleep With The Roaches - Young Dolph
Just Like Martin - IDK
Ziplock - Saba
SITUATIONS - Paris Texas
OH GOD - marinelli
BERNADETTE - Zack Villere
The Bright Lights - flora cash
My Way - Lathan Warlick
If You Change Your Mind - Hunter Hayes
Used To Be (feat. Wiz Khalifa) - Steve Aoki
Malibu - Virginia To Vegas
C.E.O. - Snoop Dogg
Asthma Pump (with Flo Milli) - Tay Money
Casa - 22Gz ðŸ•’
WHY WOULD I (feat. Lil Durk) - YXNG K.A
Baby - ROE
Crush - Ethel Cain
Cherry In Tacoma - Benjamin Francis Leftwich
Evergreen - Bendigo Fletcher
Broken Bells - Greta Van Fleet
How Am I Still Alive? (with Lydia Night) - Lauran Hibberd
Sticky - The Maine
MANY FACES - dad sports
Over It - Drax Project
River - Tom Gregory
Me Fije - Alex Rose
Toxic (ft. BEAM) - Maeta
Opps - TheHxliday
ZaZa - JayDaYoungan ðŸ•’
Federal - Bfb Da Packman
TACKLE - Joey Trap
Wok - Lil Gotit
Her Body - Nasty Cherry
videogame - Hudi
Circles - Lourdiz
Out of My Mind (feat. Camper) - Kierra Sheard ðŸ•’
Never Wanna Be - Levi Hummon
I Will Be A Lion (feat. Jake Reese) - KSHMR
Mine (feat. Rubi Rose) - Trap Manny ðŸ•’
Boys To Men - Lil Poppa
Super Pain - Guwop Reign
GOD LEVEL FREESTYLE - BBY KODIE ðŸ•’
Chico Estrella - Duki
Slow Dance - Tucker RiveraEmbed