2 ContributorsNew Music Friday 08/12/22 LyricsNicki Minaj - Super Freaky Girl
Megan Thee Stallion - Her
Rod Wave - Yungen (feat. Jack‚ÄÖHarlow)
Rex‚ÄÖOrange County -‚ÄÖTHREAT
PinkPantheress - Picture in my mind
Ari‚ÄÖLennox - Hoodie
DaBaby - WAITRESS
Anitta - El Que Espera
JID - Dance Now (with Kenny Mason)
NIKI - Keeping Tabs
Genevieve Stokes - Habits
Omar Apollo - Endlessly
Paulo Londra - Noche de Novela (feat. Ed Sheeran)
Ali Gatie - The Look (feat. Kehlani)
347aidan - so what!
YG - Toxic
Tyga - Sunshine
Tones And I - Charlie
Maddie Zahm - Inevitable
Ronald Isley - Make Me Say It Again, Girl
Internet Money - 2k in tha Soda (feat. LUCKI)
Rae Sremmurd - Community D**k (feat. Flo Milli)
Bella Poarch - Living Hell
GAYLE - indieedgycool
nicole han - BLUSH!
Parmalee - Girl In Mine
Babyface - Seamless (with Kehlani)
Ozuna - Somos Iguales
Flowers - Hypnotic (feat. Uffie)
Cordae - Unacceptable
Alicia Keys - Stay (feat. Lucky Daye)
Jessie Reyez - MUTUAL FRIEND
Pale Waves - Clean
Amelia Moore - love me or leave me alone
Afrojack - Day N Night
Kodak Black - Haitian Scarface
The Game - O.P.P. (YoungBoy Never Broke Again)
Danger Mouse - Strangers (feat. A$AP Rocky and Run The Jewels)
M.I.A. - Popular
Yeah Yeah Yeahs - Burning
Renny Conti - Email üêö
mehro - pretty kids
Ber - Superspreader
Lost Kings - Under The Influence
Four Tet - Mango Feedback üêö
Santigold - Shake
Toosii - Lonely
EST Gee - Love Is Blind
Jordan Davis - Next Thing You Know
Joshua Bassett - Smoke Slow
Death Cab for Cutie - Foxglove Through The Clearcut
Shallou - Us
Young Nudy - Impala
Morray - Ticket
Mannywellz - No Closure
Broken Bells - Saturdays
Vundabar - Time
Beach Weather - Unlovable
Zeds Dead - In My Head
Destroy Lonely - NOSTYLIST
Jack & Jack - Runaway
Chappell Roan - Femininomenon
The Goo Goo Dolls - Going Crazy
First Aid Kit - Out of My Head
Lainey Wilson - Watermelon Moonshine
Blessing Offor - My Tribe
Fabolous - SAY LESS (with French Montana)
Lil Zay Osama - Chase Em Down (feat. G Herbo)
Sylvan Esso - Echo Party
Alvvays - Easy On Your Own?
Kelsey Waldon - Backwater Blues
Surf Curse - Lost Honor
Sleeping With Sirens - Let You Down (feat. Charlotte Sands)
Tessa Violet - Kitchen Song
Junior Varsity - Singapore
Banoffee - Angel Girl
Transviolet - Love and Power
Lane 8 - Grapevine
Ashley Cooke - getting into
Vincent Mason - Made 4 üêö
Santa Fe Klan - Ll√©vame
Samuel Petra - Can't You See üêö
Nesta - City of Angels üêö
Rob49 - Yes, You Did (with Real Boston Richey)
AUGUST 08 - Minivan
grentperez - Ego
Ryann - Nineties
Panda Bear - Gettin‚Äô to the Point
Hudson Mohawke - Intentions
always centered at night - on air
The Hellp - meant2be
Bellah - In The Moment
courtship. - Sheryl Crow
Hannah Ellis - Country Can
Lathan Warlick - Long Way (feat. KB)
Jenevieve - Love Quotes
Ice Spice - Munch (Feelin' U)
Tedeschi Trucks Band - Soul Sweet Song
Brian Fuller - Burn Me Out
Grace McKagan - K-Town üêöEmbed