1 ContributorNew Music Friday 07/01/22 LyricsCardi B - Hot Shit (feat. Ye & Lil Durk)
Steve Lacy - Bad Habit
Fred again.. – Jungle
Calvin Harris - New Money (feat. 21 Savage)
Imagine Dragons - I Don't Like Myself
Gucci Mane - All Dz Chainz (feat. Lil Baby)
Tiësto - Hot In It
City Girls - Good Love (feat. Usher)
Rina Sawayama - Catch Me In The Air
Luke Bryan - Country On
Kygo - Never Really Loved Me (with Dean Lewis)
J-hope – MORE
J Balvin - Nivel De Perreo
Yeat - Rich Minion
347aidan - Bad Reputation - Spotify Singles
Dermot Kennedy - Dreamer
Gryffin - Recklеss (with MØ)
Joey Bada$$ - Where I Bеlong
Montell Fish - love you more than me
Sudan Archives - NBPQ (Topless) YUNGBLUD - Don't Feel Like Feeling Sad Today
Lauv - Kids Are Born Stars
The Chainsmokers - Why Can't You Wait
Muni Long – Cartier
Bazzi - Miss America
Sabrina Carpenter – Vicious
Jxdn - Beautiful Boy
Mozzy - Lurkin (feat. EST Gee)
Mabel - Let Love Go
Paulo Londra – Luces
Paolo Nutini – Radio
Broken Bells - We're Not In Orbit Yet…
Claire Rosinkranz - i'm too pretty for this
Daya - Love You When You’re Gone
Oscar Lang - I've Never Been To LA
RAYE - Hard Out Here
REASON - Barely Miss
Emotional Oranges - Make Me Wanna
Rêve - Tongue
Quinnie - touch tank
Snail Mail - Feeling Like I Do - Spotify Singles
Lil Silva - Leave It
Headie One - Bigger Than Life
Lloyd Banks – Menace
Flo Rida - What A Night
LP Giobbi - All In A Dream
Fancy Hagood - Blue Dream Baby
Little Big Town - All Summer
The Rare Occasions – Seasick
Aaron May - No Recognition
DJ Drama - Forever
Zion & Lennox – Berlin
Bicep - Meli (II)
Alice Longyu Gao - Believe the Hype (feat. Oli Sykes)
Two Friends - Timebomb (feat. MOD SUN)
Kylie Morgan - If He Wanted To He Would
Brian Kelley - American Spirit
Renforshort - Julian, king of manhattan
Catie Turner - Step Mom
Savannah Conley - Best I Can
Men I Trust - Hard to Let Go
Peach PRC - Teenage Dirtbag – Spotify Singles
Tay Money – PTDOM
Enchanting - What I Want (feat. Jacquees)
THEY - Comfortable (feat. Fana Hues)
Bow Anderson – Selfish
Fiji Blue - Up Down
Anna of the North - Dandelion
Zachary Knowles – CIGARETTES
Shinedown - Hope
MOTHICA – NOCTURNAL
Siiickbrain – Jealousy
Clay "Krucial" Perry III - Done Did (feat. Tay Keith)
Bino Rideaux - IF U EVER
Iayze - Cracked (I’m Him 2)
Ray Laurél - COCONUT PERFUME
Skeez – country anywhere
Jax - Victoria’s Secret
Matilda Mann – Hell
Gia Woods – Lesbionic
Glimji - Rush
Wisin - Volar (feat. Los Legendarios)
Sonny Digital - Since 91 (feat. $LUGG)
G Perico - Legitimate
Nakkia Gold - Sober (With Jeremih)☑️
Maya Hawke – Thérèse
Abby Sage - Pool Party
The Goo Goo Dolls - Yeah, I Like You
Fillmore - USA
Dustin Lynch - Fish In The Sea
Symba - Never End Up Broke
KillBunk - My World
NNAMDÏ - I Don't Wanna Be Famous
Peach Fuzz - Hey Dood
Richie Quake - Rollin Around
Tanner Adell - Love You a Little Bit
Victoria Canal - pity season
Housewife - Bones (God Like You)
The Sunshine State - Pushing 30You might also likeEmbed