2 ContributorsWomen of Jazz LyricsNicole Atkins - Bye Bye Blackbird
Nina Simone - Feeling Good
Norah Jones - Come Away With Me
Bria Skonberg - Dance Me to the End of Love
Etta James - At Last
Diana Krall - L-O-V-E
Jolie Holland - Old Fashioned Morphine
Kat Edmonson - Summertime
Esperanza Spalding - I Know You Know
Jill Barber - Petite fleur
Peggy Lee - Fever
Andra Day - Forever Mine
Diana Krall - Night And Day
Dee Dee Bridgewater - Hound Dog
Leyla McCalla - The Capitalist Blues
Somi - Alien
Billie Holiday - Strange Fruit
Kandace Springs - Forbidden Fruit
Nina Simone - I Put A Spell On You
Rose Cousins - Lock and Key
Madeleine Peyroux - Dance Me To The End Of Love
Daniela Andrade - La Vie En Rose
Betti - Ordinary
Cécile McLorin Salvant - Monday
Ella Fitzgerald - Dream A Little Dream Of Me (Single Version) (feat. Louis Armstrong)
Bessie Smith - Nobody Knows You When You're Down and Out
Jennifer Leitham - Stick It In Your Ear
Cécile McLorin Salvant - I Didn’t Know What Time It Was
Nikki Yanofsky - Jeepers Creepers 2.0
Brenna Whitaker - You Don't Own Me
Fats Waller - Honeysuckle Rose (feat. Jane Monheit)
Macy Gray - I Try
Ashni - Light Bends (Live Session)
Zara McFarlane - Plain Gold Ring
Diana Krall - The Look Of Love
George Gershwin - I Got Rhythm (feat. Ira Gershwin, Ethel Waters)
Esperanza Spalding - Earth To Heaven
Aretha Franklin - Rock-A-Bye Your Baby with a Dixie Melody
Susie Arioli - Un jour de différence
Gabrielle Stravelli - Dream Dancing
Eartha Kitt - C'est Si Bon
Peter Appleyard - Smile (feat. Diana Panton)
Emilie-Claire Barlow - Don’t Think Twice, It's Alright
Blanche Calloway - Without That Gal!
Gretchen Parlato - Weak
Scott Bradlee's Postmodern Jukebox - It's A Man's Man's Man's World (feat. Morgan James)
Éyal Hai - You & I (feat. Margaret Glaspy)
Lizz Wright - Hit The Ground
Charles Mitchell - You Are My Sunshine (feat. Jimmie Houston Davis, Barbra Lica)
Lil Hardin Armstrong And Her Orchestra - Clip Joint
Lovie Austin And Her Serenaders - Too Sweet for Words (Live)
Sweet Emma Barrett - A Good Man Is Hard To Find
Mann Holiner - Until the Real Thing Comes Along (feat. L.E. Freeman, Saul Chaplin, Alberta Nichols, Valaida Snow, Studio Orchestra, StudioConductor)
Ina Ray Hutton - Blue Skies
Eliane Elias - Little Paradise
The International Sweethearts Of Rhythm - Swing Shift
Charlie Shavers - J.P. Vanderbilt IV (feat. Herbie Fields, Marjorie Hyams)
Amina Claudine Myers - Dirty No-Gooder's Blues
Mildred Bailey - A Cigarette a Silhouette
Anita O’Day - ’S Wonderful / They Can't Take That Away From Me (feat. Oscar Peterson Quartet)
Mary Lou Williams - It Ain’t Necessarily So
Rosemary Clooney - Sway (with Pérez Prado y Su Orquesta)
Stacey Kent - Never Let Me Go
Betty Carter - My Favourite Things
Nancy Wilson - The Boy From Ipanema
Abbey Lincoln - Do Nothing 'Til You Hear From Me
Alice Coltrane - Turiya & Ramakrishna
Lena Horne - I Got It Bad And That Ain't Good
Carmen McRae - The Sound Of Silence
Dianne Reeves - One For My Baby
Dee Dee Bridgewater - Les Feuilles Mortes / Autumn Leaves
Shirley Horn - Hit The Road Jack
Buika - Stand by me (feat. Jacob Sureda)
Sarah Vaughan - It Don't Mean A Thing (If It Ain’t Got That Swing)
Kay Starr - "It's A Good Day"
Raymond Scott - All This and Heaven Too
Annette Hanshaw - Daddy Won't You Please Come Home (with The New Englanders)
Jane Green - Honeybunch
Dinah Washington - Cry Me A River
Aziza Mustafa Zadeh - Always (feat. Dave Weckl, John Patitucci)
Blossom Dearie - 'Deed I Do
Barbara Carroll - 'Tis Autumn
Lovie Austin - Steppin' on the Blues (feat. Tommy Ladnier, Jimmy O'Bryant)
Dorothy Donegan - I Just Want To Sing
Eliane Elias - Falling In Love With Love
Geri Allen - Feed the Fire (feat. Palle Danielsson, Lenny White, Johnny Coles)
Jutta Hipp - Violets For Your Furs (Remastered 2007/Rudy Van Gelder Edition) (feat. Zoot Sims)
Kait Dunton - Real & Imagined
The New Mastersounds - Your Love Is Mine (feat. Corinne Bailey Rae) (Nostalgia 77 Remix)
Jennifer Leitham - I'm Afraid the Masquerade Is Over
Sophie Milman - Beautiful Love
Melody Gardot - Worrisome Heart
April Barrows - Lost In A Blue NoteEmbed