1 ContributorNew Music Friday 10/07/22 LyricsCharlie Puth - Loser
Quavo - To The Bone (feat. YoungBoy Never Broke Again)
Jean Dawson - BAD FRUIT*
WILLOW - ur a < stranger >
Ty Dolla $ign - My Friends (feat. Lil Durk)
Nicki Minaj - Likkle Miss - THE FINE NINE REMIX
Gracie Abrams - Difficult
Jazmine Sullivan - Stand Up (From the Original Motion Picture "Till")
G Herbo - Shordie (with Gunna)
Yahritza Y Su Esencia - Inseparables
MÃ¥neskin - THE LONELIEST
A Boogie Wit da Hoodie - B.R.O. (Better Ride Out)
YoungBoy Never Broke Again - Pimpin A Bitch
Alex Vaughn - So Be It
Fred again.. - Kammy (like i do)
Hozier - Swan Upon Leda
Mimi Webb - Ghost of You
Dayglow - Radio
Ozuna - MaÃ±ana
Dermot Kennedy - Innocence and Sadness
Shawn Mendes - Carried Away
Cat Burns - People Pleaser
SleazyWorld Go - Creepers
Gryffin - Scandalous (with Tinashe)
TSHA - Anxious Mind
Maisie Peters - Not Another Rockstar
Nessa Barrett - tired of california
thuy - girls like me don't cry
Avery Anna - la di da
bbno$ - top gun
Toosii - Date Night
Joyce Wrice - Bittersweet Goodbyes
Justin Moore - You, Me, And Whiskey
Carly Rae Jepsen - The Loneliest Time (feat. Rufus Wainwright)
Alvvays - After The Earthquake
chloe moriondo - Plastic Purse
Sadie Jean - Locksmith
Vianney - Call on me (feat. Ed Sheeran)
DDG - Bulletproof Maybach (feat. Offset)
NLE Choppa - Do It Again (feat. 2Rare)
ACRAZE - Believe (feat. Goodboys)
GAYLE - snow angels
Kevin Atwater - star tripping
Mickey Guyton - How You Love Someone
Kali Uchis - La Unica
Rory - Don't Go
easy life - FORTUNE COOKIE
Tion Wayne - Letâ€™s Go (feat. Aitch)
Kay Flock - Geeked Up (feat. Gucci Mane)
Joshua Bassett - would you love me now?
Ari Abdul - HUSH
Stray Kids - CASE 143
LF SYSTEM - Hungry (For Love)
Amaria - All For You
Billy Strings - Long Journey Home
Lyn Lapid - Detached
Haley Joelle - Magical Thinking
Aidan Bissett - All That I'm Craving
Surf Curse - Randall Flagg
Connie Constance - Hurt You
Kiana LedÃ© - Who Do You Think You Are
Tasha Cobbs Leonard - It Is Well - Live ðŸ•’
Flo Rida - High Heels
Thomas Day - Wildflower
joe p - French Blonde
Royal & the Serpent - Love Abuser (Save Me)
Broken Bells - One Night
Jamila Woods - Boundaries
Samaria - Insanity (feat. Tone Stith)
Kali - Bout U
Shaboozey - Snake
Hiba Tawaji - Que Sera Sera (Law Nebka Sawa) ðŸ•’
RÃªve - Whitney
iamnotshane - What Doesnâ€™t Kill You Mutates and Tries Again
KILLBOY - MY CRUSH
Oh Wonder - 22 Make
Valley - There She Goes - Spotify Singles
Sawyer - Mistake
Lily Rose - Whatcha Know About That
Alok - All By Myself
Justin Quiles - La Esquina del Mall
Dreamer Isioma - Dumb In Love With You
Bien et Toi - Dream About You (feat. Halima)
AMARIA BB - Live Some Life (feat. DING DONG)
Lebra Jolie - What Kinda
Fridayy - Don't Give Up On Me
Rich Homie Quan - Bigger Jeans (feat. NoCap)
Lamb of God - Ditch
All Time Low - Sleepwalking
Sam Austins - Matador
Sharon Van Etten - Never Gonna Change
Bonny Light Horseman - Fleur de Lis
Courtney Marie Andrews - Thinkin' On You
CIL - One More Shot
AJA - How Do You Sleep?
RINI - Selfish (feat. BEAM)
Casper Magico - La Mini
young friend - i don't care
Nippa - Where They AtEmbed