3 ContributorsNew Music Friday 10/27/17 LyricsSelena Gomez & Marshmello - Wolves
Clean Bandit - I Miss You feat. Julia Michaels
Migos - Motor Sport feat. Nicki Minaj & Cardi B
Sasha Sloan - Ready Yet
Majid Jordan - Gave Your Love Away
Kelly Clarkson - Heat
Ty Dolla $ign - Lil Favorite feat. MadeinTYO
MØ - When I Was Young
Kygo - Never Let You Go feat. John Newman
PnB Rock - Issues feat. Russ
Rachel Platten - Shivers
Gavin James - Hearts On Fire
Yo Gotti - Yellow Tape feat. 21 Savage
Blackbear & Tinashe - up in this
Alan Walker, Noah Cyrus & Digital Farm Animals - All Falls Down
Jeremy Zucker - ghosts
Don Diablo - Take Her Place feat. A R I Z O N A
Sam Smith - Burning
Jackson Penn - Streetlights on Mars
RedOne, Daddy Yankee, French Montana & Dinah Jane - Boom Boom
Tyga - Stay in School
Gordon Downie - Wolf's Home
Franz Ferdinand - Always Ascending
WALK THE MOON - Surrender
JOHN.k - Wrong
Liz Huett - H8U
Happy Sometimes - Love for the Weekend
Grace VanderWaal - City Song
LOYAL - Light Up For Me
Cautious Clay - Joshua Tree
Mansionair - Astronaut (Something About Your Love)
Weezer - Happy Hour
Jillian Jacqueline - I Feel It Coming (Recorded At Sound Stage Nashville)
Jeezy - Cold Summer feat. Tee Grizzley
Pitbull - Por Favor feat. Fifth Harmony
Linkin Park & Steve Aoki - One More Light (Steve Aoki Chester Forever Remix)
Malia - Champagne Clouds
Chris Brown - Everybody Knows
Big K.R.I.T. - 1999 feat. Lloyd
The Game - Oh I feat. Jeremih, Young Thug & Sevyn
24hrs - What You Like feat. PnB Rock & MadeinTYO
Ronny J - Thriller (Forever) feat. Ski Mask The Slump God
DJ Snake - Broken Summer feat. Max Frost
TYSM - Ghost White Dress
The Brinks - Comatose
Tourist - Hush
Snoop Dogg - 3's Company feat. Chris Brown & O.T. Genasis
Starley - Been Meaning To Tell You
PRETTYMUCH - Open Arms
Kaptan - Moving On
MisterWives - Never Give Up On Me
Miley Cyrus - Bad Mood (Recorded at Spotify Studios NYC)
Lucy Rose - End Up Here
Au/Ra - Outsiders
Aminé - Squeeze
SOPHIE - It's Okay To CryEmbed