2 ContributorsNew Music Friday 08/02/19 LyricsAriana Grande - boyfriend (with Social House)
Lauv - fuck, i'm lonely (with Anne-Marie) - from “13 Reasons Why: Season 3”
Clairo - Softly
Gryffin - OMG (with Carly Rae Jepsen)
YUNGBLUD - Hope For The Underrated Youth
HAIM - Summer Girl
BROCKHAMPTON - I BEEN BORN AGAIN
Oliver Tree - Do You Feel Me?
Drake - Club Paradise
Sabrina Claudio - Holding The Gun
RAYE - Love Me Again
Foals - Black Bull
Flume - Quits
ILLENIUM - Blood (with Foy Vance)
Quality Control - Longtime
Ava Max - Freaking Me Out
Tyga - Bop
Lil Durk - Die Slow (feat. 21 Savage)
Mabel - OK (Anxiety Anthem)
Quality Control - Intro
Noah Cyrus - July
Tyler Childers - Country Squire
Julian Lamadrid - Neon
The Lumineers - Leader Of The Landslide
Alexander 23 - Another Summer Night Without You
Tove Lo - Bad As The Boys
Nicky Jam - Atrévete
Teyana Taylor - How You Want It?
Rich The Kid - Flex Up
Red Hearse - Everybody Wants You
Angel Olsen - All Mirrors
Luke Combs - Let's Just Be Friends - From The Angry Birds Movie 2
Death Cab for Cutie - Kids in '99
courtship. - Amy, Run For The Hills
YK Osiris - Shakira
Aya Nakamura - Pookie (feat. Lil Pump) - Remix
Miquela - Money
Denzel Curry - I Against I - Recorded at Spotify Studios NYC
Dave East - Everyday (feat. Gunna)
Kash Doll - Here I Go
Kiana - Playing With Fire
Tori Kelly - 2 Places
Volbeat - Die To Live
half•alive - ok ok?
Midland - Cheatin’ Songs
Chiiild - Count Me Out
Rapsody - Ibtihaj
R3HAB - Alive
NOTD - Keep You Mine
Lil West - Want Love
daydream Masi - Lately
99 Neighbors - Fake Pods
Yoshi Flower - Rolling Thunder
Channel Tres - Black Moses (feat. JPEGMAFIA)
Luh Kel - Pull Up
Raphael Saadiq - So Ready
Blue Nude - 20
Carnage - Slot Machine (feat. Prinze George)
Franklin - Drowning
Josh A - Outbreak
Ghostface Killah - Party Over Here
Korn - Cold
Vic Mensa - Let U Know
Conor Maynard - Not Over You
MisterWives - whywhywhy
The Highwomen - The Chain - From the Motion Picture Soundtrack "The Kitchen"
Sheryl Crow - Tell Me When It’s Over
Ra Ra Riot - Belladonna
Snoh Aalegra - Situationship
Cassie - Teach Me
Hermitude - OneFourThree
Snoop Dogg - Countdown (feat. Swizz Beatz)
ricky retro - Freak On Me (feat. Icona Pop)
Lindsey Stirling - The Upside (feat. Elle King)
Abraham Mateo - Me Vuelvo Loco
Pitbull - 3 to Tango
Cousin Stizz - STP
NGeeYL - Lullaby (feat. Young Nudy)
The Growlers - Natural Affair (Single Edit)
morgxn - OMM!
William Bolton - Serendipity
Grandma - No Doors
Daniela Andrade - Polly Pocket
TisaKorean - Watermelon Booty
Tom Tripp - Glow
Navvy - If I Can't Have You
Lou The Human - Suspicious
Slow Hollows - You Are Now on Fire
Penny and Sparrow - Gumshoe
Mosa Wild - Honey
Bre Kennedy - Jealous Of Birds
Sharna Bass - 4:30am
tobi lou - Cheap Vacations (feat. Facer)
Pardison Fontaine - Shea Butter
Keke Palmer - Twerk N Flirt
Yungeen Ace - Mountains
Skillet - Victorious
TOOL - SoberEmbed