3 ContributorsNew Music Friday 3/13/20 LyricsTones And I - Bad Child
Lil Yachty - Oprahâ€™s Bank Account (Lil Yachty & DaBabyâ€…feat.â€…Drake)
Jay Electronica -â€…Flux Capacitor
OneRepublic - Didn't I
Niall Horanâ€…- Black And White
Lil Uzi Vert - Myron
Tyga - FREAK
Ellie Goulding - Worry About Me (feat. blackbear)
FLETCHER - Forever
Rich The Kid - Stuck Together (feat. Lil Baby)
Don Toliver - Cardigan
The Killers - Caution - Radio Edit
Rita Ora - How To Be Lonely
Flume - The Difference
Anderson .Paak & Justin Timberlake - Don't Slack (from Trolls World Tour)
Alaina Castillo - i don't think i love you anymore - Recorded at Electric Lady Studios NYC
Ava Max - Kings & Queens
Kehlani - Toxic
Deb Never & Kenny Beats - Stone Cold
YNW Melly - Suicidal (Remix) [feat. Juice WRLD]
Machine Gun Kelly - Bullets With Names (feat. Young Thug, RJMrLA & Lil Duke)
Jack Harlow - I WANNA SEE SOME ASS (feat. jetsonmade)
DaniLeigh - Levi High (feat. DaBaby)
Yaeji - WAKING UP DOWN
Lennon Stella - Jealous
mxmtoon - quiet motions
Mustafa - Stay Alive
Alina Baraz - Morocco (feat. 6LACK)
CHIKA - CROWN
bbno$ & Lentra- mememe
Wiz Khalifa - Bammer (feat. Mustard)
Lil Tecca - All Star (feat. Lil Tjay)
Kiana LedÃ© - Forfeit. (feat. Lucky Daye)
[KennyHoopla - the world is flat and this is the edge//]() ğŸš
Sub Urban - Freak (feat. REI AMI)
[Love Regenerator - Give Me Strength]() ğŸš
Tainy, Justin Quiles & Dylan Fuentes- TU AMIGA (feat. Lennox & Llane)
Luke Bryan - One Margarita
Grouplove - Inside Out
Two Feet - Maria
JoJo - Man
RAC - Stuck On You
Boy In Space - u n eye
Camilo & Evaluna Montaner - Por Primera Vez
R3HAB & Elena Temnikova - Where You Wanna Be
[Felix Jaehn - SICKO]() ğŸš
Blueface - Weekend (feat. Lil Baby)
Fivio Foreign - Big Drip (Remix) (feat. Lil Baby & Quavo)
Lele Pons - Volar (feat. Susan Diaz & Victor Cardenas)
Maya B - Sink
Felly - Something Restless
Yumi Zouma - Lonely After
Shallou & Zachary Knowles - Mutual Love
Georgia - everything i wanted - Recorded live at Abbey Road Studios, London
Yung Pinch - 21
Mozzy - Tunnel Vision
Dinah Jane - Lottery
renforshort - bummer
Gia Woods - EGO
Rence - Type 2
A.CHAL - Pink Dust
[DJ Esco & Doe Boy - Pop It]() ğŸš
Ace Hood - Confident
Shawn Wasabi - HOME RUN
ALMA - Stay All Night
Porter Robinson - Something Comforting
Shoffy - Bedhead (feat. Anna Clendening)
Caitlyn Smith - Feel That Way
Arrested Youth - Brightside
Kacy Hill - I Believe In You (feat. Francis and The Lights)
POORSTACY - Empty Room
[Jimi Somewhere - Selfish]() ğŸš
Yves Tumor - Kerosene!
[Orion Sun - Lightning]() ğŸš
[Soleima - Grind (feat. Yoshi Flower)]() ğŸš
[Jucee Froot - Sidewalk]() ğŸš
Symba - Serve
Guapdad 4000 - Greedy
Lil West & Brevin Kim - Bleach
Bickle - Naked
Porches - I Wanna Ride
[Nick Leng - Music to Clean the House to]() ğŸš
SoMo - Sinkin' Down
[Haiti Babii - Thug Thizzle]() ğŸš
[Kierra Luv - Good Day]() ğŸš
Black Atlass - By My Side (feat. Sonia)
Nacho & Chyno Miranda - Raro
Felix Cartal & Sophie Simmons - Mine
Joywave - Coming Apart
KALEO - Alter Ego
[Logan Mize - Hometown]() ğŸš
Margo Price - Twinkle Twinkle
Alaska Reid - Amber
GAYLE - z
Lastlings - Take My Hand
MAJ - Love Always
Dee Watkins - Hood Poet
[Sy Ari Da Kid - Used To Lames]() ğŸš
[ALLBLACK - The Goal Line]() ğŸšEmbed