3 ContributorsNew Music Friday 02/24/17 LyricsZedd & Alessia Cara - Stay
Future - Selfish feat. Rihanna
Calvin Harris - Slide feat. Migos & Frank Ocean
The Chainsmokers & Coldplay - Something Just Like This
Ed Sheeran - Shape of You feat. Nyla & Kranium (Major Lazer Remix)
Stormzy - Cold
Yellow Claw - Good Day feat. DJ Snake & Elliphant
John Mayer - Helpless
Little Big Town - Don't Die Young, Don't Get Old
Marshmello & Ookay - Chasing Colors feat. Noah Cyrus
Lana Del Rey - Love
Jason Derulo - Swalla feat. Nicki Minaj & Ty Dolla $ign
THEY. - Motley Crew
Khalid - American Teen
NAV - Lonely
Ruth B. - Superficial Love
Kelly Clarkson & Aloe Blacc - Love Goes On
Billie Eilish - Bellyache
Violet Days - Suck at Love
Spoon - Can I Sit Next to You
Enrique Iglesias - SUBEME LA RADIO feat. Descemer Bueno & Zion & Lennox
Era Istrefi - Redrum feat. Felix Snow
London Grammar - Big Picture (THRDL!FE Remix)
The 1975 - By Your Side
Sam Feldt & Hook N Sling - Open Your Eyes
Busy P - Genie feat. Mayer Hawthorne
6LACK & Jhene Aiko - First Fuck
Wale - Fashion Week feat. G-Eazy
Allan Rayman - Head Over Heels
Kent Jones - Sit Down feat. Ty Dolla $ign, Lil Dicky & E-40
POWERS - Heavy
Bea Miller - burning bridges
BRÅVES - A Toast
Harrison Brome - Body High
DJ Premier & Miguel - 2 LOVIN U
Thundercat - Walk On By feat. Kendrick Lamar
Alex Da Kid & Joseph Angel - American Funeral
Slow Dancer - Don't Believe
Rexx Life Raj - Waiting for You feat. Russ
Tei Shi - How Far
Smino - Blkoscars feat. Jay2
Ella Mai - Anymore
Life of Dillon - Rocks
Marky Style & Guy Gabriel - Karma feat. Roxanne
Kato & Sigala - Show You Love feat. Hailee Steinfeld
Meghan Trainor - I'm a Lady
Brandyn Burnette - Manifest
Gnash - lonely again
Emma Dewing - Buttons
Devin Dawson - Secondhand Hurt
Brett Eldredge - Somethin' I'm Good At
Rhiannon Giddens - Better Get It Right the First Time
Leif Vollebekk - Michigan
MAGIC GIANT - Set On Fire
Bush - Lost In You
Seether - Let You Down
Dirty Projectors - Cool Your Heart
Hurray For The Riff Raff - The Navigator
StéLouse - Shivers N Gold feat. Mascolo
Lia Marie Johnson - Cold Heart Killer
Pell - Patience
Soleima - Breathe feat. Hoodboi
Junior A - Sleep Machine
Kendall Morgan - Silver Spoon
José James - Ladies Man
Biyo - Focus
Sulene - Haunting
James Vickery - Lately
Calum Scott - Golden Slumbers (Recorded At Spotify Studios NYC)
Lukas Graham - You're Not There (Grey Remix)
Steve Aoki & Louis Tomlinson - Just Hold On (DVBBS Remix)
XYLØ - Get Closer (Joe Mason Remix)
Ten Fé - Twist Your Arm (Roman Flügel Remix)Embed