2 ContributorsTop Artists of 2018 LyricsDrake - Nonstop
Post Malone - Candy Paint
XXXTENTACION - Moonlight
J Balvin - No Es Justo feat. Zion & Lennox
Ed Sheeran - Shape of You
Eminem - Lucky You feat. Joyner Lucas
Ozuna - Síguelo Bailando
Bad Bunny - MIA feat. Drake
Khalid - OTW feat. 6LACK & Ty Dolla $ign
Ariana Grande - thank u, next
Kendrick Lamar & SZA - All The Stars
Imagine Dragons - Bad Liar
Travis Scott - SICKO MODE
Dua Lipa & BLACKPINK - Kiss and Make Up
The Weeknd & Kendrick Lamar - Pray For Me
Kanye West - Yikes
David Guetta, Martin Garrix & Brooks - Like I Do
BTS - FAKE LOVE
Maroon 5 - Don't Wanna Know feat. Kendrick Lamar
Cardi B - Money
Marshmello - Stars
Migos - MotorSport feat. Nicki Minaj & Cardi B
Shawn Mendes - In My Blood
Taylor Swift - Delicate
Camila Cabello - She Loves Control
Calvin Harris & Sam Smith - Promises feat. Jessie Reyez
Daddy Yankee & Anuel AA - Adictiva
Rihanna - Work feat. Drake
Bruno Mars - Finesse (Remix) feat. Cardi B
Coldplay - Yellow
LSD - Thunderclouds
The Chainsmokers - Sick Boy
Demi Lovato - Sorry Not Sorry
Nicki Minaj - Chun-Li
Future - Fine China feat. Juice WRLD
Sam Smith - Pray
Maluma - El Préstamo
Chris Brown - Questions
Queen - Bohemian Rhapsody
Selena Gomez - Back To You
J. Cole - KOD
Halsey - Without Me
Juice WRLD - All Girls Are The Same
Kygo & Imagine Dragons - Born To Be Yours
Logic & Marshmello - Everyday
The Beatles - Come Together
Lil Uzi Vert - New Patek
The Carters - APESHIT
G-Eazy - 1942 feat. Yo Gotti & YBN Nahmir
Martin Garrix - Ocean feat. KhalidEmbed