2 ContributorsNew Music Friday 08/30/19 LyricsPost Malone - Circles
Pusha T - Coming Home (feat. Ms. Lauryn Hill)
benny blanco - Graduation (with Juice WRLD)
Tones and I - The Kids Are Coming
Lil Tecca - Shots
Lana Del Rey - Norman fucking Rockwell
Big Sean - Bezerk (feat. A$AP Ferg & Hit-Boy)
A$AP Rocky - Babushka Boi
Skrillex - Midnight Hour with Boys Noize & Ty Dolla $ign
TOOL - 7empest
GASHI - Safety (feat. DJ Snake)
Charli XCX - Warm (feat. HAIM)
Bebe Rexha - Not 20 Anymore
Bombay Bicycle Club - Eat, Sleep, Wake (Nothing But You)
Miranda Lambert - Way Too Pretty for Prison (with Maren Morris)
mxmtoon - dream of you
Duckwrth - Crush
Pusha T - Sociopath (feat. Kash Doll)
SiR - You Can't Save Me
Tate McRae - tear myself apart
Jax Jones - Jacques
Snakehips - Summer Fade (feat. Anna of the North)
H.E.R. - Be On My Way (Full)
Wale - BGM
Dimelo Flow - El Favor (with Nicky Jam & Farruko, feat. Sech, Zion & Lunay)
Delaney Jane - Hello My Loneliness
Angels & Airwaves - Kiss & Tell
Whitney - Friend Of Mine
John Newman - Without You
EARTHGANG - UP
Godfather of Harlem - Just in Case (feat. Swizz Beatz, Rick Ross & DMX)
Lil Tracy - Bad For You
Sub Urban - Isolate
Astrid S - Doing To Me
Sudan Archives - Confessions
Vagabon - Water Me Down
Cigarettes After Sex - Heavenly
Sheryl Crow - Wouldn’t Want To Be Like You
White Reaper - 1F
Sean Paul - When It Comes To You
Birdman - Ride Dat
24kGoldn - Games On Your Phone
American Authors - Champion (feat. Beau Young Prince)
Simple Creatures - Thanks, I Hate It
Yoke Lore - Everybody Wants To Be Loved
Ruel - Real Thing
Jason Derulo - Too Hot
Jhay Cortez - Deséame Suerte
Blaatina - Watch Out
SOB X RBE - Doggy Dogg World
Common - God Is Love [Feat. Leon Bridges & Jonathan McReynolds]
Deb Never - Swimming
Peach Tree Rascals - Mariposa
Caravan Palace - Moonshine
Remi Wolf - Rufufus
Mozzy - Sad Situations (feat. NoCap)
Bernard Jabs - Come Again (feat. iann dior)
Walkabout - comehangoutcuzimagoodtime
James Blunt - Cold
Kris Kross Amsterdam - Ooh Girl (feat. A Boogie Wit da Hoodie)
Matoma - All Around The World (feat. Bryn Christopher)
AMMO - I Like It Alot
The Alchemist - Tropical Storm Lenny (feat. Action Bronson)
Justine Skye - Too Much
Madison McFerrin - TRY
Sophie Meiers - x-ray vision
Alok - Tell Me Why
Dillon Francis - GO OFF (Nuthin' 2 It)
JP Saxe - Women Who Look Like You (feat. Guapdad 4000)
nyan - real you
BOI - Sick of Loving You
Ashley McBryde - One Night Standards
Tim McGraw - Drive
Trisha Yearwood - Find a Way
G Flip - Lover
No Vacation - Estrangers
!!! - Couldn't Have Known
Rauw Alejandro - Fantasias
K-391 - Play
Lindsey Stirling - Artemis
Celeste - She's My Sunshine
Karlae - Shut Up And Listen (feat. Lil Duke)
Natasha Bedingfield - Kick It
Parker McCollum - Pretty Heart
EMMA WAHLIN - Technicolor
Fiji Blue - Numb
Amenazzy - Desierto
Otto Knows - About You
Dzeko - Down On It (feat. Kool & The Gang)
PNAU - All Of Us
Joell Ortiz - Screens
BigKlit - Make Me Feel
Yung Mal - War (feat. Gunna)
Griff - Didn't Break It Enough
Monsune - outta my mind
Froogle - Riding With Me
Fozzy - Nowhere To RunEmbed