1 ContributorNew Music Friday 04/01/22 LyricsHarry Styles - As It Was
Shawn Mendes - When You're Gone
Lil Tjay - In My Head
Kehlani - up at night (feat. justin bieber)
Glass Animals - Solar Power - Spotify Singles
Thomas Rhett - Where We Started
Gryffin - You Were Loved (with OneRepublic)
City Girls - Top Notch (feat. Fivio Foreign)
A Boogie Wit da Hoodie - Playa (feat. H.E.R.)
Ella Mai - Leave You Alone
Miley Cyrus - You - Live
Japanese Breakfast - Skinny Love - Spotify Singles
Flume - Sirens (feat. Caroline Polachek)
Latto - Big Energy (feat. DJ Khaled) - Remix
5 Seconds of Summer - Take My Hand
Chris Brown - WE (Warm Embrace)
YoungBoy Never Broke Again - 4KT Baby
Dreamville - Stick (with JID & J. Cole feat. Kenny Mason & Sheck Wes)
Freddie Gibbs - Ice Cream (feat. Rick Ross)
Red Hot Chili Peppers - These Are the Ways
Arlo Parks - You're The One - Spotify Singles
Surfaces - I Can't Help But Feel
EMELINE - cinderella's dead
Alexander 23 - Crash
Keith Urban - Nightfalls
Pabllo Vittar - Follow Me
42 Dugg - Everybody Shooters Too
Joyner Lucas - Ye Not Crazy
√ÑTNA - I See Love
Beach Bunny - Fire Escape
Olivia O'Brien - Bitches These Days
Yeat - 3G (feat. Lil Uzi Vert)
NLE Choppa - Yak Flow
Enrique Iglesias - Espacio en Tu Coraz√≥n
Faouzia - RIP, Love
JVKE - this is what heartbreak feels like
Dean Lewis - Hurtless
Lloyiso - Speak
Vince Staples - ROSE STREET
Tom Odell - Best Day Of My Life
Matoma - Heart So Big
Jimmie Allen - Un-Break My Heart - Spotify Singles
Masked Wolf - Fallout
Surf Curse - Sugar
Blu DeTiger - Hot Crush Lover
Spill tab - Sunburn
Sofi Tukker - Kakee
Wiz Khalifa - Iced Out Necklace
Never Broke Again - Pull Up Actin (Never Broke Again featuring YoungBoy Never Broke Again and P Yungin)
Arooj Aftab - DI MI NOMBRE - Cap.8: √âxtasis - Spotify Singles
Angel Olsen - All The Good Times
Flowerovlove - Will We Ever Get This Right
Isaac Dunbar - Tainted Love
ELIO - Vitamins
Alok - Run Into Trouble
Hardwell - INTO THE UNKNOWN
NCT DREAM - Glitch Mode
Mora - 2010
Young M.A - Tip The Surgeon
Savannah R√© - Last One
Redveil - better
Aldn - sink
Renforshort - made for you
Slimdan - Magazines
Lilyisthatyou - ALL ABOUT ME
Caitlyn Smith - Dreamin's Free
Cassidy Mann - Tropical Sour Candy
Lights - Okay Okay
Lupe Fiasco - 100 Chicagos
Tee Grizzley - Buss It All Down
Kalan.FrFr - Popstar
Superorganism - It's Raining
Congee - Honest
Jackson Wang - Blow
A$AP ANT - The God Hour
Trinidad Cardona - Hayya Hayya (Better Together) - Music from the FIFA World Cup Qatar 2022 Official Soundtrack
Miraa May - Wild Things
Chance Pe√±a - Sleep Deprivation
THE BLSSM - NOT TODAY
Corook - snakes
PUP - Relentless
LORA - reel
Jason Aldean - God Made Airplanes
Nightly - hate my favorite band
Nickname jos - SORE
Chicocurlyhead - DIADREAMER
Totally Enormous Extinct Dinosaurs - Blood In The Snow
Christian Alexander - WYHA?
Flores - Exito
T-Shyne - Still Ain‚Äôt Finished (feat. Gunna)
Matisse - Un Nuevo Amor
Molly Tuttle & Golden Highway - Castilleja
Kevin Morby - Rock Bottom
Karley Scott Collins - Tattoos
ELEVATION RHYTHM - Has anyone ever left you high and dry?
NoonieVsEverybody - GOT A FEELING üêö
MIXIE - boomerang
JT FOLEY - scaredy cat
London Mars - Basement SuperstarYou might also likeEmbed