2 ContributorsNew Music Friday 10/20/23 Lyricsblink-182 - ANTHEM PART 3
The KID LAROI, Jung Kook & Central Cee - TOO MUCH
Charli XCX & Sam Smith - In The City
beabadoobee & Laufey - A Night To Remember
The Rolling Stones - Mess It Up
21 Savage & d4vd - Call Me Revenge (Call of Duty: Modern Warfare 3)
Sabrina Carpenter - I Knew You Were Trouble - Spotify Singles
Kali Uchis - Te Mata
2 Chainz & Lil Wayne - Presha
Chris Brown - Sensational (feat. Davido & Lojay)
Gucci Mane - Must Be Me
Fuerza Regida - EXCESOS
Sam Hunt - Came The Closest
Sampha - Suspended
The Chainsmokers & GRACEY - Think Of Us
City Girls - Work For It
Caroline Polachek - Dang
Slayyyter - Monster - Spotify Singles
YoungBoy Never Broke Again - Heard Of Me
Marshmello, P!nk & Sting - Dreaming
Dove Cameron - Lethal Woman
Steve Aoki & Paris Hilton - Lighter
Lil Tjay & Kyle Richh - I Should've Known
Mike WiLL Made-It - Different Breed (feat. Swae Lee & Latto)
Ovy On The Drums, Quevedo & Yandel - GANGSTER (PQFNEDG)
Restless Road - Go Get Her
Searows - Funny
Bombay Bicycle Club & Damon Albarn - Heaven
Anitta - Mil Veces
Rick Ross & Meek Mill - Lyrical Eazy
Key Glock - Murder & Millions
IDLES & LCD Soundsystem - Dancer
ISOxo - how2fly
Griff - Into The Walls
Kevin Abstract - What Should I Do?
Chris Lane - Mistake
Emei - 711
Q - Hello
Dermot Kennedy - Sunday
YUNGBLUD, Oli Sykes & Bring Me The Horizon - Happier
Flo Milli - BGC
â€‹will.i.am & J Balvin - LET'S GO
Arin Ray - Moonlight
Hans Williams - Georgia Walks
Morgan Wade - Halloween
Grupo Frontera - AMOR PROPIO
Maddie Zahm - Bedroom
The Rare Occasions - Black Balloons
ivri - limbo
Mustafa - Name of God
iann dior - Low Tide
Odetari - GREEN GOBLIN - Spotify Singles
Lola Brooke - Pit Stop (feat. French Montana)
Wale - Max Julien
Sam Feldt & Sofiloud - Memories
Poolside - Sea Of Dreams
Danny Brown - Tantor
Zacari & Ty Dolla $ign - Ave Maria
Elmiene - Someday
Holly Macve - Suburban House
Gabito Ballesteros & Natanael Cano - LOU LOU
Sango - Drifted (feat. Jayla Darden)ðŸ•’
Jay Rock & Ab-Soul - Blowfly
Ross Lynch & THE DRIVER ERA - Rumors
Alkaline Trio - Blood, Hair, And Eyeballs
MICHELLE - GLOW
Naomi Sharon - Push (feat. Omah Lay)
EKKSTACY - bella
Mk.gee & Two Star - Are You Looking Up
Terrace Martin & Alex Isley - Glad I Found You
Brooke Ligertwood - Bless God
Jake Scott - Twice
BADBADNOTGOOD & Charlotte Day Wilson - Sleeper
Timbaland & Anna Margo - My Way
UPSAHL - NO HANDS (SIDE A)
Lyrical Lemonade, Lil Tracy & Corbin - Hello There
BOYS LIKE GIRLS - MIRACLE
Vacations - Close Quarters
Kurt Vile - Another good year for the roses
Luke Grimes - Where It's Blue
Brandon Lake - PALM OF YOUR HAND
Sierra Ferrell - Fox Hunt
James Bay - All My Broken Pieces
TALK - History
Allison Russell - Take Me To Church - Spotify Singles
New West - Retrograde
Knuckle Puck - You & I
Duckwrth - 007 (Jersey Mix)ðŸ•’
Jazzy - Stardust
Jockstrap - Good Girl
Justin Timberlake - Perfect
RealestK - Mr. Lonely
Hotboii & ATL Jacob - NASA
Berhana - Wow!
Jekalyn Carr - You Carried Me - Jekalyn's Version
Barry Can't Swim - Always Get Through To You
Mannequin Pussy - I Don't Know You
Jane Remover - Backseat Girl
jigitz - first time
CORPSE - DISDAINEmbed