1 ContributorNew Music Friday 6/11/21 LyricsPolo G - No Return (with The Kid LAROI & Lil Durk)
Lorde - Solar Power
Doja Cat - Need To Know
Migos - Having Our Way (feat. Drake)
Megan Thee Stallion - Thot Shit
Maroon 5 - Lost
Kelsea Ballerini - I Quit Drinking
Clairo - Blouse
SAINt JHN - Just For Me (with SZA) - Space Jam: A New Legacy
Marshmello - Shockwave
Polo G - Black Hearted
Don Toliver - Fast Lane
J Balvin - OTRO FILI
H.E.R. - We Made It
Ava Max - EveryTime I Cry
Topic - Chain My Heart
Trevor Daniel - Fingers Crossed (with Julia Michaels)
Mimi Webb - Dumb Love
Tyga - Splash (feat. Moneybagg Yo)
Tkay Maidza - Cashmere
Tones And I - Cloudy Day
RAYE - Call On Me
Skrillex - Supersonic (My Existencе) [with Noisia, josh pan & Dylan Brady]
Ricky Martin - Que Rico Fuera
Gucci Mane - Likе 34 & 8 (feat. Pooh Shiesty)
French Montana - FWMGAB
KennyHoopla - smoke break//
Gus Dapperton - Sober Up
Deb Never - Disassociate
Emotional Oranges - Back & Forth (feat. Vince Staples)
Kodak Black - Feelin' Peachy
Yung Bleu - Baddest
Pi’erre Bourne - Sossboy 2 (feat. Lil Uzi Vert)
James Arthur - September
Bleachers - How Dare You Want More
Olivia O'Brien - No More Friends (with Oli Sykes of Bring Me The Horizon)
Slayyyter - Villain
Alan Walker - Sweet Dreams
Jessie J - I Want Love
MARINA - Venus Fly Trap
FLETCHER - She Said
Lillian Hepler - Used to That
Larry June - Intercepted (feat. Money Man)
GoldLink - White Walls
Rema - Soundgasm
Amber Mark - Competition - Single Edit
Ritt Momney - Escalator
X Ambassadors - My Own Monster
Kameron Marlowe - Folsom Prison Blues - Spotify Singles
Calum Scott - Biblical
Jessie Ware - 0208
Don Diablo - Too Much To Ask
JayDaYoungan - Murder
EST Gee - Bigger Than Life Or Death
IDK - Peloton
Peggy Gou - Nabi
Curtis Waters - BAD MOOD (feat. Brevin Kim)
Valley - SOCIETY
John K - everything
AJ Mitchell - ONE MORE FIGHT
Yebba - October Sky
Chris Young - Rescue Me
Kylie Morgan - Mad I Need You
Billy Strings - Wargasm [Feat. RMR]
Oscar Lang - 21st Century Hobby
UPSAHL - Melatonin
Lil Gotit - Playa Chanel (feat. Young Thug)
Benny The Butcher - Sink
Feid - FUMETEO
Tone Stith - Be Quiet (feat. Kiana Ledé)
HONNE - WHAT WOULD YOU DO? (feat. Pink Sweat$)
Two Feet - Fire In My Head
K.Flay - Dating My Dad (feat. Travis Barker)
Cold War Kids - What You Say
Mother Mother - Sick of The Silence
José González - Head On
Marian Hill - oOo that's my type (feat. Yung Baby Tate)
PmBata - favorite song
TWICE - Alcohol-Free
Liv Grace Blue - Bad Chick
Simone - Girl Like Me
Ruth B. - Spaceship
Raissa - FREE
Mac Wetha - Wayside
Garbage - The Creeps
Sleater-Kinney - Method
VINCINT - Getaway (feat. Tegan and Sara)
Bizarrap - Eladio Carrion: Bzrp Music Sessions, Vol. 40
NoCap - Time Speed
Bobby Sessions - Penthouse Prayers (feat. Rick Ross)
Yungeen Ace - Giving Up
Ann Marie - Like That
Anthony Ramos - Home All Summer (from In The Heights)
BETWEEN FRIENDS - ok
The Greeting Committee - Can I Leave Me Too?
Alex Warren - One More I Love You
QVE - Chaos!
Kidd Kenn - B4
Jasmine Thompson - already there
Bo Burnham - FaceTime with my Mom (Tonight)Embed