2 ContributorsNew Music Friday 10/13/17 LyricsP!nk - For Now
Cheat Codes - Feels Great feat. Fetty Wap & CVBZ
Blackbear - playboy shit feat. lil aaron
Lost Kings - First Love feat. Sabrina Carpenter
Daya - New
Morgan Wallen - Up Down feat. Florida Georgia Line
Kiiara - Wishlist
Kris Wu - Deserve feat. Travis Scott
Alesso & Anitta - Is That For Me
Tory Lanez - Real Thing feat. Future
Gucci Mane - Enormous feat. Ty Dolla $ign
Kehlani - Honey
Lil Peep - Avoid feat. Wicca Phase Springs Eternal & Doves
Beck - Fix Me
FRANKIE - Paper Doll
St. Vincent - Slow Disco
Mikky Ekko - Blood On The Surface
Jonas Blue - We Could Go Back feat. Moelogo
Louis Tomlinson - Just Like You
Chris Brown - High End feat. Future & Young Thug
Dvsn - Morning After
Marc E. Bassy - Made Love First feat. Kehlani
Dillon Francis - Hello There feat. Yung Pinch
H.E.R. - 2
Ella Vos - Mother (Don't Cry)
Russell Dickerson - Would You Love Me
Logic & Juanes - 1-800-273-8255 feat. Alessia Cara & Khalid
Bishop Briggs - Dream
Dagny - Love You Like That
Yoke Lore - Truly Madly Deeply (Recorded at Spotify Studios NYC)
Noel Gallagher's High Flying Birds - Holy Mountain
AWOLNATION - Passion
Julien Baker - Turn Out the Lights
The Vamps - Personal feat. Maggie Lindemann
DOLF & Yellow Claw - Vertigo feat. Caroline Pennell
WALK THE MOON - Headphones
The Beaches - Money
Chase Rice - Eyes On You
Bruno Martini & Timbaland - Road feat. Johnny Franco
The Knocks & Captain Cuts - House Party
Will Joseph Cook - If You Want To Make Money
Frank Walker - Piano feat. Emily Warren
Girl Blue - Dreams
LANY - Sign Of The Times (Spotify Studios NYC)
Nick Murphy - Medication
Peking Duk - Let You Down feat. Icona Pop
Fickle Friends - Hard To Be Myself
Tom Walker - Leave a Light On
Jessie Reyez - Phone Calls
Baka Not Nice - Money in the Bank
King Krule - Biscuit Town
Emily Warren - Poking Holes
Jessie James Decker - Hold a Candle
The Barr Brothers - Kompromat
Courtney Barnett & Kurt Vile - Fear Is Like a ForestEmbed