1 ContributorNew Music Friday 8/6/21 LyricsThe Weeknd - Take My Breath
Aventura - VolvÃ­
Jack Harlow - SUVs (Black on Black)
Lil Tecca - REPEAT IT (with Gunna)
blackbear - @ my worst
220 KID - Stupid Feelings
Ingrid Andress - Wishful Drinking (with Sam Hunt)
Nelly - High Horse (feat. BRELAND and Blanco Brown)
Jorja Smith - All of This (Jorja Smith x GuiltyBeatz)
FINNEAS - A Concert Six Months From Now
Holly Humberstone - Please Don't Leave Just Yet
Kito - Steal My Clothes (feat. Bea Miller)
Nas - Rare
Black Eyed Peas - HIT IT (feat. Saweetie & Lele Pons)
Martin Garrix - Love Runs Out (feat. G-Eazy & Sasha Alex Sloan)
Gryffin - New Blood (with Boy Matthews)
glaive - 1984
Pop Smoke - Rumble (feat. Tay Floss)
YNW Melly - Best Friends 4L (feat. Lil Tjay)
Omar Apollo - California Dreaminâ€™ - Spotify Singles
LILHUDDY - Don't Freak Out (feat. iann dior, Tyson Ritter & Travis Barker)
Fredo Bang - Oou Oou (feat. Coi Leray)
Hotboii - Oath
KSI - Lose
Adam Levine - Good Mood - Original Song From Paw Patrol: The Movie
Nessa Barrett - i hope ur miserable until ur dead
marcos g - lights coming down
Wet - Larabar
TSHA - Power ğŸ•’
Sara Kays - Struck By Lightning (feat. Cavetown)
MAY-A - Central Station
Victoria MonÃ©t - Coastin'
Tony Bennett - I Get A Kick Out Of You
Becky Hill - Business (with Ella Eyre)
Anuel AA - Los De Siempre
Young Nudy - Green Bean
Tierra Whack - Walk The Beat
Tinashe - Undo (Back To My Heart)
Nea - No Regrets
Noah Kahan - Animal
Lillian Hepler - Moody Girl
Alaina Castillo - wish you were here
Blake Rose - Casanova
Chris Young - At the End of a Bar
Allison Ponthier - Faking My Own Death
Big Red Machine - Mimi (feat. Ilsey)
Hippo Campus - Sex Tape
Natti Natasha - Noches en Miami
Helene Fischer - Vamos a Marte (feat. Luis Fonsi)
Trae Tha Truth - Off Top (feat. Moxiii Double Dee & Jared) ğŸ•’
Slimelife Shawty - Slatt Bizness
Trapboy Freddy - Freddy (feat. Young Thug)
Yung Bae - Silver and Gold (feat. Sam Fischer & Pink Sweat$)
Bickle - Talk Words
ElyOtto - Profane - extended
Fred again.. - Baxter (These Are My Friends) ğŸ•’
Luz - permanent +1
Zachary Knowles - life sentence
Bryce Vine - Miss You a Little (feat. lovelytheband)
Fiji Blue - Only When I Look into Your Eyes
Joy Crookes - Skin
India Shawn - Donâ€™t Play With My Heart
Nio Garcia - Tus Poses
Flight Facilities - Move (feat. DRAMA)
Young Saab - girls in town (feat. Nana Lourdes & Rome Fortune)
Purity Ring - soshy
mehro - coastline
OSTON - Sour
for KING & COUNTRY - Relate
Ashley Cooke - Good Goodbye (feat. Jimmie Allen) ğŸ•’
Luke Bryan - Songs You Never Heard
Luke Hemmings - Place In Me
YOG$ - Someday
Unknown Mortal Orchestra - That Life
Jenevieve - RÃ©sumÃ©
Yung Lean - Chandelier
Posh Chocolates - Gravity
DVBBS - Leave The World Behind
Majestic - Losing My Mind
Spice - Bad Girl (feat. Shaggy) ğŸš
Saucy Santana - Jigga Who
JAHMED - BODYBAG
Papa Roach - Swerve (feat. Fever333 & Sueco)
OCTAVIO the Dweeb - Nights Like This ğŸ•’
Evann McIntosh - COCO PEBBLES ğŸ•’
ill peach - UP UP AND AWAY
Susto - Get Down
Leah Blevins - Little Birds
Lauren Daigle - Tremble - Live
Houndmouth - Las Vegas
Justin Nozuka - Nova
Cyn - Wonderful ğŸ•’
Saint Bodhi - Get Like This
Raw Youngin - From the Block
Paris Bryant - Tragedy
Jor'dan Armstrong - CAN'T ğŸ•’
EVAN GIIA - By My Side ğŸ•’
Oslo Ibrahim - Blanket of Sadness (feat. Rendy Pandugo) ğŸ•’
Sans Soucis - On Time For Her
Often - Palm TreesEmbed