3 ContributorsNew Music Friday 12/04/20 LyricsErrbody - Lil Baby
Teach Me How To Love - Shawn Mendes
Real Shit (with benny blanco) - Juice WRLD
B.B. King Freestyle (with Drake) - Lil Wayne
Coco (feat. Dababy) - 24kGoldn, Dababy
Blinding Lights (with ROSALÍA) - Remix - The Weeknd
Acting Like That (feat. Machine Gun Kelly) - YUNGBLUD
Name - spill tab
Loser (feat. Trippie Redd) - Rico Nasty
On Me - Dababy
None of Your Love - Lil Tjay
Excuse My Pain - J.I The Prince of N.Y
Más De La Luna - Piso 21, Maluma
Call My Friends - Shawn Mendes
Reason - Jordana
Better Days (feat. Justin Timberlake) - Ant Clemons
Goosebumps - Bastille, Kenny Beats
Are U Live - Chance the Rapper, Jeremih
So Heartless - Rich The Kid
Lento - Mr Eazi, J Balvin
Swimming In The Stars - Britney Spears
One Whole Day (feat. Wiz Khalifa) - Dixie D'Amelio
Lotus Inn - Why Don't We
Stay Next To Me (with Chelsea Cutter) - Quinn XCII
In Over My Head - grandson
Sitting In Fire - MASN
Southern Symphony - Russell Dickerson
Another Year - FINNEAS
It'sNotOver - CHLOBOCOP
Last Laugh - Fletcher
Magazines - Emanuel
Move - Jany Green
Dunya (feat. LukeyWorld) - GoldLink
I Don't Wanna Feel No More - reggie
Dance Like Nobody's Watching - Yuna
Both of Us (feat. Rick Ross & Layton Greene) - YFN Lucci
No Negotiations - Sheff G
Chosen (feat. Ty Dolla $ign) - Blxst, Tyga
Mrs. Clean - Aminé
You Ain't Worth It (with 6LACK) - Melii
I Feel Fantastic - Serena Isioma
We Out Here - Rina Sawayama
Do It All Over (feat. Marc E. Bassy) - Cheat Codes
sympathy 4 the grinch - 100 gecs
do u care, if i stare? - SEBii
Bossa Nova (feat. Tee Grizzley) - Kash Doll
Let It Rain (feat. 6LACK) - Yung Baby Tate
Bussin' Out (feat. Lil. Mosey & Ty Dolla $ign) - DJ Scheme
Loner - Maggie Lindemann
GO - MIA GLADSTONE
Dress - Charlotte Sands
Drinkin' Beer. Talking God. Amen. (feat. Florida Georgia Line) - Chase Rice
bad kids (feat. Yoshi Flower) - Royal & the Serpent
Something Has Changed - Oscar Lang
Look Away - Verzache
PRIMADONNA - Sueco
Menace - Hotboii
So High - Tm88, Wiz Khalifa, Roy Woods
Shoutout To My Dentist - YBN Almighty Jay
Still I Rise (feat. Jackboy) - Kamaiya
Peace Of Mind - Rema
bb u ok? - San Holo
Enchantment - Nora En Pure
Runaway - Lost Kings, Destiny Rogers
High Waist Jeans - Wolf
Soft Spot - Claud
Good Girls (Don't Get Used) - Beach Bunny
Slow Dancing - Aly & AJ
Show Me Around - Carly Pearce
Panic Attack - Langhorne Slim
I'm Here - Celeste
Love Somebody - Rotimi
HUGBABY (feat. Gunna) - Justin Rarri
Fighting Pain - Yungeen Ace
Low Key - Morray
All Da Action - YSB Tril
All Good - Samm Henshaw
Say I Won't - MercyMe
Feeling Good (feat. Snow Tha Product & CNG) - Natanael Cano
KELOKE - KHEA
Za Za - Lourdiz
ken doll - boyband
Age of Machine - Greta Van Fleet
Time Fades Away - Two Feet
Little Deaths - Sir Sly
The Captain Is Drunk - Jack Johnson
Don't Be A Fool - Dreamer Boy
EMPATHY - Yoandri
Selfish - Stephanie Poetri
I Love Glitchcore (feat. XIX) - Cmten
4 The Fashion - Smoove'L
Out The Window - Lo Village
Homebound - Jak Bannon, Mr Carmack
honest - phem, iann dior
read receipts - maxime.
Tears of Gold - David Bisbal, Carrie Underwood
Better Than Me - Unghetto Mathieu
Classy Bitch - LBS Kee'vin, Juicy J
On Me - SNF.JT, Rikki
Addicted 2 U - Ben ChandlerEmbed