16 ContributorsAugust 2023 Singles Release Calendar Lyrics8/1
Georgia Gets By - "Happiness Is An 8 Ball"
Hannah Georgas - "Home"
Miles Chancellor - "Starcrossed"
Nao - "Balance" ft. Skillibeng
Orla Gartland - "Kiss Ur Face Forever"
Sauce Walka - "ONLY FANS"
Tunji Ige - "Passion & Pain"
Vistas - "Nowadays"
8/2
CXR, Chris Patrick & Dende - "Stuck In Your Ways"
FIZZ - "As Good As It Gets"
Gretta Ray - "Don't Date The Teenager"
James Blunt - "Beside You"
LP - "Love Song"
Nia Archives - "Bad Gyalz"
REASON - "The Soul Pt. 3" ft. 9th Wonder
Snoh Aalegra - "Sweet Tea"
Stormzy - "Angel In The Marble"
YK Osiris & Lloyd - "Dear Fans (Remix)"
8/3
BiC Fizzle - "Mr Biggs" ft. BIG30 & Cootie
Chesca & Mariah Angeliq - "Bicha"
Cosha - "Sun Back"
Danna Paola - "Tenemos Que Hablar"
DC The Don - "Tell Shyanne"
DENNIS, Maluma & KAROL G - "Tá OK (Remix)" ft. MC Kevin O Chris
Giggs & Diddy - "Mandem"
Jorja Smith - "GO GO GO"
​​M Huncho & Slim - "any minute"
Natti Natasha - "NO PARE"
No Guidnce - "Let It Rain"
Sett - "2 For 1"
Stephen Sanchez - "Be More"
8/4
26AR - "MY SET PT. III"
AK - "Hunt For Mine"
Alina Baraz - "Keep Me In Love"
Almondmilkhunni - "Playlist"
Bailey Zimmerman - "Religiously (Religiously. The Acoustic Sessions.)"
Bebe Rexha & David Guetta - "One in a Million"
Becky Hill, Chase & Status & Tiësto - "Disconnect (Tiësto Remix)"
BoyWithUke - "Trauma"
Cannons - "Desire"
Cel NoLackin - "Told U"
Ciara & Chris Brown - "How We Roll"
Cordae - "Make Up Your Mind"
Dan + Shay - "Always Gonna Be"
Davina Michelle - "Dating the Devil"
Delta Goodrem - "Back To Your Heart"
Desiigner - "Young N Ballin"
Doja Cat - "Paint The Town Red"
Dopamine & Sigala - "Feel It Deep Inside"
Dylan - "Liar Liar" ft. Bastille
Ez Mil & Eminem - "Realest"
Felix Cartal & Karen Harding - "Need Your Love"
Fresco Trey - "Got You" ft. charlieonnafriday
Grace Kinstler - "Not Me It’s You"
Halle - "Angel"
HYRA - "AIR U BREATHE" ft. Michael Medrano
Icewear Vezzo - "Love In The City"
Ivy Queen, Brray & Marconi Impara - "Toma (Remix)" ft. Lennox & Eix
Jade Novah - "Affirm Me"
James Arthur - "Blindside"
JELEEL! - "WAHALA!"
Jordan Ward & 6LACK - "MUSTARD"
Kali Uchis - "Muñekita" ft. JT & El Alfa
Kalan.FrFr - "BUTTERFLY COUPE" ft. Tyga
Katelyn Tarver - "Parallel Universe"
KayCyy - "CUT IT OUT" ft. SoFaygo
KayCyy - "My Jeans"
Kevin Gates - "I Don't Apologize"
Kevin Ross - "Ready For It" ft. Eric Bellinger
Lakeyah - "In Da Club"
Lana Del Rey - "Say Yes To Heaven (AMANDUS 99 +++ DANZINGER 99 Remix)"
Lana Del Rey - "Say Yes To Heaven (Anyma Remix)"
LANY - "XXL"
Lauv - "Love U Like That"
LE SSERAFIM - "이브, 프시케 그리고 푸른 수염의 아내 (Eve, Psyche & The Bluebeard's wife) (Remix)" ft. Demi Lovato
Lil Zay Osama - "Got It No Mo"
Lil Skies - "Wake Up"
Mae Stephens - "Mr. Right" ft. Meghan Trainor
Marley Bleu - "unintentional" ft. Pink Sweat$
Matty Marz - "m.w.u"
Michal Leah & Caleb Hearn - "Think I’m Gonna Love You"
midwxst - "warning"
Nathan Dawe, Joel Corry & Ella Henderson - "0800 HEAVEN (Luca Schreiner Remix)"
Noodah05 - "Don't U See"
Odeal - "Repercussions"
Rexx Life Raj - "Cleanse"
Rob49, Skilla Baby & Tay B - "Mama"
Rowdy Rebel - "ROB WHO?"
Saiko - "Antidepresivos"
Swavy & Vory - "Fallback Queen"
Swedish House Mafia - "Ray of Solar"
The Paper Kites - "I Don't Want to Go That Way"
Tones and I - "The Greatest"
Trippie Redd - "Left 4 Dead"
Tungevaag - "Lonely Hearts"
Usher, 21 Savage & Summer Walker - "Good Good"
Voda Fuji - "NTRSLY"
Wiz Khalifa - "Hype Me Up"
ZEDNED - "sticky situation"
8/8
BRONZE AVERY - "SEX IN THE ROOM"
Coach Party - "Parasite"
Dokken - "Fugitive"
Molly Burch - "Unconditional"
Money Man - "Fear No Man"
Morgan Myles - "Vertigo"
No Rome - "Deep Diving"
8/9
Alexander Stewart - "i wish you cheated"
Äyanna - "Say You Love Me"
BiC Fizzle - "Cruise Control"
Jamie Miller - "No Matter What"
Lil Zay - "Racks In My Sleep" ft. TKK Tony
Pipo Beatz & La Zowi - "Ya Fue"
Tove Lo - "Elevator Eyes"
Ventino - "La Mitad"
Vince Staples & The Alchemist - "Lonnie P"
yeule - "ghosts"
8/10
Álvaro Díaz - "SUKI"
BigWalkDog - "I Promise"
Elyrix & Gunna - "Day Off"
EST Gee - "A MOMENT WITH GOTTI" ft. Yo Gotti
Headie One - "More Money More Problems"
Jessica Mauboy - "Give You Love" ft. Jason Derulo
KATO2X - "Off The Head" ft. Key Glock
Lil Darius - "Lamborghini Boys" ft. Nardo Wick & Tay Keith
Llane - "Casi"
Mae Muller - "Me, Myself & I (Acoustic)"
METTE - "Van Gogh"
MoStack - "Cap 2 Da Side"
NEEDTOBREATHE - "Hideaway"
Paty Cantú - "La Otra"
Talia Mar - "Forget About Your Ex"
Yeat - "bigger thën everything"
8/11
1017 ALYX 9SM & Lil Yachty - "Warriors"
Ali Gatie - "Nobody Like Us"
All Time Low - "Calm Down (A Little Bit Louder Now)"
Alok & Ava Max - "Car Keys (Ayla) [feat. Ayla] [Tiësto Remix]"
Amber Ais - "Crying Over Boys"
Black Birdie - "When I Was Ten (Acoustic)"
Big Yavo - "Facts"
Bonnie McKee - "Hot City"
Carrie Underwood - "Give Her That"
CG5 - "Ruined Lullaby"
Chappell Roan - "HOT TO GO!"
Childish Major - "I Still Love H.E.R." ft. Ambré
COBRAH - "MANIC"
Cody Johnson - "The Painter"
Colbie Caillat - "Still Gonna Miss You"
Dash Berlin, DubVision & Emma Hewitt - "Time After Time (Ashley Wallbridge Remix)"
Daughtry - "Artificial"
Derivakat & Netrum - "Cycle"
DJ Khaled, Lil Baby & Future - "Supposed To Be Loved" ft. Lil Uzi Vert
Eli Sostre - "Judas Effect"
Elley Duhé - "DELIRIUM"
Elthia - "wildfire"
FAF Pa've - "Racks Comin In" ft. Roddy Ricch
Fred again... & Obongjayar - "i adore u"
French Montana - "Good Summer"
Ghostface Killah - "YUPP!" ft. Remy Ma
Gucci Mane - "Now It's Real"
HunterGirl - "Ain't About You"
James Bay - "Goodbye Never Felt So Bad"
Jazmin Bean - "Favorite Toy"
Jess Glynne - "What Do You Do? (MK Remix)"
JP Saxe - "Caught Up On You"
KAMILLE - "Time To Kill"
Lawrence - "i'm confident that i'm insecure"
LAYA - "Need 2 Know"
Lewis Thompson - "No Promises"
Lil Zay Osama - "Stranded"
Lucas Estrada, Alex D’Rosso & Badjack - "Jaded"
Luke Bryan - "Southern and Slow"
Maroon 5 & Mickey Guyton - "Middle Ground"
Metric - "Nothing Is Perfect"
Miguel - "Number 9" ft. Lil Yachty
N3WYRKLA - "care about myself"
Olivia Rodrigo - "bad idea right?"
Pentatonix - "I Rise"
Prentiss - "Achieve"
Sigrid - "The Hype"
Taryn - "Give It To Me"
That Chick Angel, Sexyy Red, FendiDa Rappa & Flo Milli - "One Margarita (Margarita Song) [Ladies Remix]"
Tom MacDonald & Adam Calhoun - "Your America"
Tone Stith - "I Need You"
Tyler Cole & Teezo Touchdown - "Crying In My Car"
UMI - "happy im"
Victoria Justice - "Only A Stranger"
YK Osiris - "Pressure"
​Zack Fox - "dummy"
Zak Abel - "How Do We Stay in Love?"
8/14
Money Man - "Gangsta Lean"
Sufjan Stevens - "So You Are Tired"
TA Thomas - "Pros and Cons"
8/15
Cherry Glazerr - "Ready For You"
Corinne Bailey Rae - "Peach Velvet Sky"
EST Gee - "XXL"
Jenn Champion - "Famous"
Lolo Zouaï - "Encore"
Maple Glider - "You At The Top Of The Driveway"
Maple Glider - "You’re Gonna Be A Daddy"
North Ave Jax & ​jetsonmade - "D.I.Y.A (Die In Your Arms)"
Priya Ragu - "Vacation"
Thirty Seconds to Mars - "Seasons"
YXNG K.A - "Prime"
8/16
Adam Melchor - "Why You"
AMAKA - "Oasis"
Big Time Rush, Maffio & Calacote - "Suave"
CHVRCHES - "Manhattan"
Death Cab for Cutie - "An Arrow In the Wall"
Dylan Sinclair - "Fly Girl"
Genesis Owusu - "Stay Blessed"
Idina Menzel - "PARADISE" ft. Nile Rodgers
Jamila Woods - "Boomerang"
Lola Kirke - "All My Exes Live in L.A." ft. First Aid Kit
​poptropicaslutz! & PmBata - "Upside Down"
Roosevelt - "Rising"
Sexyy Red & Sukihana - "Hood Rats"
Tessa Violet - "Play With Fire (Remix)" ft. Frances Forever
Usher - "Boyfriend"
Wild Nothing - "Headlights On" ft. Hatchie

8/17
Anitta - "Casi Casi"
Aya Nakamura - "Bisous"
Aya Nakamura - "Chérie"
Aya Nakamura - "Come back"
Brandon Kai - "Dead To Me"
Broderick Jones - "On the Edge" ft. Nohemy
Brye - "NOTHING!"
Chloe Adams - "Barbie Doll"
Hannah Diamond - "Perfect Picture"
Kelly Clarkson - "mine (Live From The Belasco)"
Mac Critter - "Successful"
The National - "Alphabet City"
The National - "Space Invader"
The Shindellas - "Ooh La La"
8/18
AK - "Loca"
Ali Gatie - "Unblock Me"
American Authors & Billy Raffoul - "Perfectly Imperfect"
Bethany Joy Lenz - "Strawberries"
Boys World - "Piña Colada"
Calum Scott - "At Your Worst"
Charlie Puth - "Lipstick"
Charlie Worsham - "How I Learned To Pray (Remix)" ft. Luke Combs
Chris Lane - "Find Another Bar"
David Archuleta - "Afraid to Love"
Davido - "UNAVAILABLE (Latto Remix)" ft. Musa Keys & Latto
Demi Lovato - "Confident (Rock Version)"
Doechii - "Booty Drop"
Dolly Parton - "Let It Be" ft. Paul McCartney, Ringo Starr, Peter Frampton & Mick Fleetwood
ELHAE & Xavier Omär - "Favourite"
FIFTY FIFTY - "Cupid (Remix)" ft. Sabrina Carpenter
Finn Askew - "Used To This"
Gucci Mane - "Broken Hearted"
Guy Sebastian - "I Chose Good"
Gwen Stefani & Blake Shelton - "Love Is Alive"
HRVY - "Stolen Heart"
Icona Pop - "Fall in Love"
ILIRA - "Look At Me Now"
Jake Miller - "What Was I Made For?"
Jessie Reyez - "JEANS" ft. Miguel
Kane Brown & Katelyn Brown - "Thank God (Live from Fenway)"
KB Mike - "My Boo"
KennyHoopla - "keep a window open//"
Kori Mullan - "Adopted Issues"
Kuttem Reese - "Black Forces" ft. Ski Mask The Slump God
Latto - "Technique (Sprite Limelight)' ft. Eric B. & Rakim
Leah Kate - "Bored"
Leah Kate - "Get In Loser"
LÉON - "Pretty Boy"
Lil Tecca & Kodak Black - "HVN ON EARTH"
Maddie Zahm - "Eightball Girl"
Madison Beer - "Spinnin"
Michaël Brun, Anne-Marie & Becky G - "Coming Your Way"
Mike WiLL Made-It - "blood moon" ft. Lil Uzi Vert
Monaleo - "​I﹤3 My Nigga"
Mýa - "Whine" ft. Bounty Killer
New West - "IYKYK"
OneRepublic - "RUNAWAY (Acoustic)"
​Paris Jackson - "hit your knees"
​Patoranking - "HIGHER"
Polo G - "Barely Holdin’ On"
Rich The Kid - "Big Pimpin'" ft. Luh Tyler
Rogue, Wyldz & Aloe Blacc - "Classic Material"
Rvssian & Byron Messia - "Tropicana"
Samaria - "tight rope"
San Holo, Whethan & Selah Sol - "NO PLACE IS TOO FAR"
Scotty McCreery - "Cab In A Solo"
Shaé Universe - "Passenger Princess"
Shay Lia - "UPSIDE DOWN"
SICKOTOY, Inna & Antonia – "Bad Girls" ft. Eva Timush
​skaiwater - "Molli"
Slayyyter - "Erotic Electronic"
Snoh Aalegra - "Wait A Little Longer"
Steve Aoki, TRINIX & Akon - "Locked Up"
Stunna Girl & JT - "Like Dat (Remix)"
Surf - "Sonny Liston"
Surf Mesa & Stevie Appleton - "First Time"
Tamera - "Poison"
Tayla Parx - "Something In My Eye"
Tinashe - "Needs"
Torine - "7 minutes in heaven"
VEDO - "Intentional"
Young Scooter & Future - "Hard To Handle"
Zedd, BEAUZ & Ellis - "Make You Say (ellis Remix)" ft. Maren Morris

8/19
Phidel & Dolvondo - "Rusted Ruins" ft. Chi-Chi

8/21
Chxrry22 - "More"
​hemlocke springs - "enknee1"
The Chemical Brothers - "Skipping Like a Stone" ft. Beck

8/22
Burna Boy - "Cheat On Me" ft. Dave
Blac Youngsta - "Mosh Pit"
Brezden - "White Ferrari"
Charlotte Day Wilson & Snoh Aalegra- "Forever"
Dinah Jane - "Ya Ya"
Rick Astley - "Never Gonna Stop"
8/23
Brent Faiyaz - "Moment of Your Life" ft. Coco Jones
Eartheater - "Pure Smile Snake Venom"
Emeli Sandè - "There For You"
KATO2X - "Kill Time"
ILAMIKE - "Chao"
Lexi Jayde - "bandages"
L'Rain - "Pet Rock"
Mitski - "Heaven"
Mitski - "Star"
Peewee Longway - "Who Am I?"
8/24
Angie McMahon - "Fireball Whiskey"
ARIA VEGA - "MI NIÑA (RubyRose_Am_98BPM)"
BiC Fizzle - "Knowing" ft. BigWalkDog
Blessd, Peso Pluma & SOG - "Ojos Azules"
Chillinit - "PAC ENERGY"
Dave & Tiakola - "Meridian"
Feid & ICON - "FERXXO 151"
Kenia OS - "Lovelove U"
Jason Derulo - "Body Count"
Maluma & Yandel - "Trofeo"
Nicole Favre - "Máncora"
Raul Clyde & Uli - "YAILIN"
YUNGBLUD - "Hated"
ZABDIEL & Ana Mena - "AVENTURA"
ZEDNED - "everything i do"
8/25
21 Lil Harold - "Hall Of Fame"
A R I Z O N A - "Hanging On"
Adri Torrón - "De Mí Para Mí"
Anastacia - "Now or Never"
AUDREY NUNA - "​locket"
Ayax & Blasfem - "Madame Bovary"
Beartooth - "Doubt Me"
BRELAND - "Cowboy Don't"
Carly Rae Jepsen - "Shadow (George Daniel Remix)"
Chris Hudson - "Ruins" ft. CG5
City Girls - "Face Down"
Conan Gray - "Winner"
D.O.D & Jax Jones - "Need You Now"
Dave & Tiakola - "Special"
French Montana & Swae Lee - "Wish U Well"
GAYLE - "Leave Me For Dead"
Gucci Mane - "There I Go" ft. J. Cole & Mike WiLL Made-It
Hannah Grae - "Screw Loose"
Hannah Mrozak - "Ride"
Hunxho - "Your Friends"
Iam Tongi & James Blunt - "Monsters"
Iggy Azalea - "Money Come"
​jake minch - "​​strip mall"
Joel Corry, MK & Rita Ora - "Drinkin’"
John Baumann - "Border Radio"
Jovanis Cain & Surf - "What You Telling Her"
Kyle Dion - "Boyfriend Jeans"
Lil Yachty - "TESLA"
Madeline The Person - "Tantrum"
Mae Muller - "MTJL"
Miles Chancellor - "Close Encounters" ft. AP The Plan
Myke Towers - "Bajo El Sol"
Miley Cyrus - "Used To Be Young"
Naomi Sharon - "Definition of Love"
Natalie Jane - "Do or Die"
NEA - "Cold Turkey"
Omar Apollo - "Ice Slippin"
Phora - "Hard 2 Forget"
SAFE - "Montego"
Selena Gomez - "Single Soon"
Soge Culebra - "Sin Él"
Switchfoot & Jonas Brothers - "The Beautiful Letdown (Jonas Brothers Version)"
Tai Verdes - "All White"
The Killers - "Your Side of Town"
Tunji Ige - "Yoruba Demon"
Tyga & YG - "PARTy T1M3"
VIC MENSA - "Blue Eyes"
Walker Hayes - "Good With Me"
Yuna - "Glory"
8/28
Kenny Muney - "UHN UHN"
8/29
SleazyWorld Go - "Got Me Hot"
8/30
EARTHGANG & Spillage Village - "Die Today"
EARTHGANG & Spillage Village - "Die Today (Extended Version)"
Imagine Dragons - "Children of the Sky (a Starfield song)"
Jorja Smith - "Falling or flying"
Sleepy Hallow - "For You" ft. TaTa

8/31
BIGBABYGUCCI - "Modern Day"
BigWalkDog - "Talk To Em" ft. Veeze
Griff - "Vertigo"
Kylie Minogue - "Tension"
Maxo Kream - "Bonecrusher" ft. Key Glock
NEEDTOBREATHE - "Temporary Tears" ft. Foy Vance
NEEDTOBREATHE- "Wasting Time" ft. Old Dominion
NOAHFINNCE - "GROWING UP ON THE INTERNET"
No Guidnce - "Yeah Yeah"
Teezo Touchdown - "You Thought" ft. Janelle Monáe
Tion Wayne & Nines - "AMEN"
Troye Sivan, PinkPantheress & Hyunjin - "Rush"
Vybz Kartel - "Ms Ontario"Embed