5 ContributorsNew Music Friday 08/26/16 LyricsSongs with a ✅ contain verified annotations and/or lyrics!

Dua Lipa - Blow Your Mind (Mwah)
Gryffin - Whole Heart feat. Bipolar Sunshine
Cashmere Cat - Wild Love feat. The Weeknd & Francis and the Lights
Empire of the Sun - High and Low
Troye Sivan - Wild feat. Alessia Cara (Young Bombs Remix) ✅
Chet Porter - Stay feat. Chelsea Cutler
Carly Rae Jepsen - Higher
Young Thug - Wyclef Jean
Timeflies - Something Wrong ✅
Jessie Reyez - Figures
Amber Mark - Way Back
Bridgit Mendler - Atlantis feat. Kaiydo
FLETCHER - Wasted Youth
​iSHi - There for Me feat. Shenie Fogo
Midnight to Monaco - One Way Ticket
CL - Lifted
Britney Spears - Slumber Party
Jeremih - London feat. Stefflon Don, Krept & Konan
Glass Animals - The Other Side of Paradise
The Heydaze - Hurt Like Hell
The Hunna - Never Enough
DREAMERS - Painkiller
SHAED - Running Through the Fields
Ingrid Michaelson - Whole Lot of Heart
Joseph - SOS (Overboard)
Jimmy Eat World - Get Right
Grouplove - Traumatized
Echos - Say It
Big Gigantic - All of Me feat. Logic & ROZES
Sam Spiegel - Mutant Brain feat. Ape Drums & Assassin
Madeintyo - Skateboard P
Ty Dolla $ign - Zaddy
Matoma - False Alarm feat. Becky Hill (Hook N Sling Remix)
Banks & Steelz - Wild Season feat. Florence Welch
Moses Sumney - Worth It
LOLO - Heard It from a Friend
Michael Bublé - My Kind of Girl
James TW - Crazy
Goodbye June - Daisy
Korn - Insane
Dinosaur Pile-Up - Might As Well
Butch Walker - East Coast Girl
Rituals of Mine - Ride or Die
Bishop Briggs - River (BURNS Remix)
Shovels & Rope - St. Anne's Parade
Brent Cobb - Black Crow
American Football - I've Been So Lost for So Long
Charlotte OC - Blackout
Gallant - Weight in Gold (Jim Eno Sessions)
DENM - Under Pressure
Shoffy - Movin On
CID & Kaskade - Sweet Memories
Goldlink - Fall In Love feat. Ciscero
De La Soul - Whoodeeni feat. 2 Chainz
Diana Gordon - Woman
GOLDHOUSE - Pleasure feat. Alexx Mack
Jackie Tech - You Can Have It All
Elephante - Hold feat. Jessica Jarrell
You Me At Six - Night People
The Naked and Famous - Laid Low
Allan Rayman - All at Once
WILLS - Solid Gold
Sorcha Richardson - Walk Away
Sweater Beats - Better feat. Nicole Millar & Imad Royal
Rob $tone - Chill Bill REMIX feat. D.R.A.M., Denzel Curry & Cousin Stizz
Vince Staples - War Ready ✅
PARRI$ - Nasty
Sammi Sanchez - Girls Talk (Latin Remix)
Sofia Carson - I'm Gonna Love You
Hoops - Going Strong
Lawrence Taylor - Tag Team
Florence & The Machine - Wish That You Were Here
Taking Back Sunday - You Can't Look Back
Led Zeppelin - Sunshine Woman (14/4/69 Rhythm & Blues Session)
The Head and the Heart - Rhythm & Blues
Citizen Four - Cold
Leikeli47 - Girl Gang
MYZICA - Drive feat. Ezra Carey
Snakehips - Cruel feat. Zayn (Ta-ku Remix)
Innanet James - Girls
Sum 41 - War1Embed