14 ContributorsSeptember 2022 Singles Release Calendar Lyrics9/1
Ava Max - "Million Dollar Baby"
Amaruuq Inu Polii - "Colloquialism"
aldn - "say what u mean" ft. Riovaz
Babyface Ray & Digga D - "Goofies"
Big Boss Vette - "How TF" ft. SleazyWorld Go
Brray - "Bichotes Con Clase"
Corina Smith & KEVVO - "Rápida"
EST Gee - "Hell"
Everything Everything - "Pizza Boy - Skream Remix"
Feid & Totoy El Frío - "De Tanto Chimbiar"
Jiubel - "Scooby Doo"
Lenny Tavárez, Chencho Corleone & Piso 21 - "CXO (A Quién No Le Gusta)"
MoStack - "Can't Forgive"
SL - "Berlin"
Skylar Stecker - "Game Day"
Sophia Scott - "If I Hadn't Been Drunk"
9/2
Alex Warren - "Headlights"
Amber Run - "Funeral"
Aqyila - "Pressure"
AViVA - "LOVE AND WAR"
Basshunter & Alien Cut - "End the Lies"
​benny blanco, BTS & Snoop Dogg - "Bad Decisions (Acoustic)"
Brandi Carlile - "You and Me On Thе Rock (In The Canyon Haze)"
Call Me Karizma - "Firе Out"
Charlie Puth - "Smells Like Me"
Dan Ebanks - "Stay Gone"
Danielle Bradbery - "A Special Place"
Dean Lewis - "How Do I Say Goodbye"
Derivakat - "Blue Moon" ft. vGumiho
Dermot Kennedy - "Kiss Me"
Dimitri Vegas & Like Mike & Kim Loaiza - "Fuego"
DJ Drama & Jeezy - "I Ain't Gone Hold Ya"
FLETCHER - "Sting"
Flo Rida & Skytech - "What A Night (Up All Night In Vegas)"
flor - "Every Night"
Giggs - "Da Maximum"
Harry Styles - "Late Night Talking (Instrumental)"
HoodCelebrityy - "Ratchet"
Jaira Burns - "I Like You Better"
Jillian Rossi - "Like A Boy"
Kali Uchis - "NO HAY LEY"
Kelly Clarkson & Dolly Parton - "9 to 5 (FROM THE STILL WORKING 9 TO 5 DOCUMENTARY)"
Kim Petras - "Running Up That Hill"
Lil Baby - "Detox"
LOONY - "First Thing Smokin'"
Lous and The Yakuza - "Handle Me" ft. Adekunle Gold
LVNDSCAPE & Cr3on - "Alone" ft. Jon Dory
Mannywellz - "Di Do"
Merlyn Wood - "ONE OF US"
MK xyz - "Baddie"
Nicki Minaj - "Super Freaky Girl (Queen Mix)" ft. JT, BIA, Katie Got Bandz, Akbar V, & Maliibu Miitch
NLE Choppa - "Little Miss"
NOTD & Hastings - "Killing Me"
Novelist - "Don't Wake Me"
Over Easy, Leondis & Britt Lari -  "Trying Too Hard"
​peach tinted - "Handsome / RIP"
Phora - "Find Hope"
PnB Rock - "Luv Me Again"
張蔓莎 (Sabrina Cheung) - "未算壞 (Maybe Someday)"
Selfmxdebless - "BodyBags2"
Sarai - "Get"
Sigala, David Guetta & Sam Ryder- "Living Without You"
SNBRN, Discrete & Sofia Karlberg - "Paperweight"
Sueco - "Funeral"
Tay Money & Monaleo - "Hands Up"
Tayc - "Ne doute pas" ft. Marjinal
Timmy Trumpet, Giorgio Prezioso & 71 Digits - "Three Little Birds"
Tom Fletcher & McFly - "Nothing Rhymes With Sausage"
Torine - "​see u in hell"
Tove Styrke - "Another Broken Heart"
TroyBoi, Tropkillaz & MC Lan - "Ninguém Dorme"
Tyga - "Fantastic"
Unlike Pluto - "Stuck"
West Blanco - "Mala Memoria"
吳青峰 (Wu Qing Feng) - "(......醉鬼阿Q) (......Drunkard Ah Q)" ft. 孫燕姿 (Sun Yanzi)
Xowie Jones - "Bury Me Alive"
Yeat - "Talk"
Yomil y El Dany - "Me Encantaría"
Zac Brown Band & James Taylor - "Love and Sunsets"
9/5
​per se - "在生 (The Lovers)"
9/6
Blessd & Ryan Castro - "Fumando"
艾粒 (ILUB) - "One Way"
古巨基 (Leo Ku) & MC 張天賦 - "自我安慰 (Self-comfort)"
The Veronicas - "Cruisin' On My Own (Lisa Veronica – The Solo Project)"
The Veronicas - "Seeing Stars (Jessie Veronica – The Solo Project)"
9/7
5 Seconds of Summer - "Older" ft. Sierra Deaton

9/8
B Young & King Promise - "Rolling Stone"
Bryson Tiller - "Outside"
黃明德 (Dark Wong) - "只想和你吃漢堡 (Teen Romance)"
DRAM - "WHAM"
María Becerra - "Automático"
​moon tang - "​i love you"
Nath & Omar Montes - "Hotel"
Roddy Ricch - "Ghetto Superstar" ft. Doe Boy & G Herbo
Tom Odell - "Smiling All The Way Back Home"
Whyte Fang - "333"
Zarahn - "精神流亡 (Spirited Away)" ft. Serrini
9/9
Ashley Kutcher - "Sleepy"
AURORA - "Hunting Shadows"
BIG30 - "On My Mama"
BigWalkDog - "Uncle Tommy"
Bilmuri - "THE VOID APPROACHETH"
BlueBucksClan - "Jeeezy WYA"
Brooke Candy - "Flip Phone"
BRS Kash - "Team Player" ft. Lil Poppa & Morray
CG5 & salem ilese - "MINION"
Charlie Puth & Jungkook - "Left and Right (Galantis Remix)"
Clean Bandit & French The Kid - "Sad Girls" ft. Rema
Coi Leray - "Fly Sh!t"
Cordae & Hit-Boy - "CHECKMATE"
CY 陳宗澤 - "罐頭湯 (Canned Soup)"
DEZ 余宗遙 - "平行線上 (Parallel Distance)"
DJ Spinall, Summer Walker & DJ Snake - "Power (Remember Who You Are)"
Dustin Lynch - "Wood On The Fire"
Eli Derby - "Wicked"
EST Gee - "Shoot It Myself" ft. Future
FLETCHER - "Better Version"
G Herbo - "Me, Myself & I" ft. A Boogie wit da Hoodie
Ivy Queen - "Villana"
Kai Whiston & Iglooghost - "Lux 3"
KILLBOY - "NAILS"
Labrinth - "Kill For Your Love"
LAYA & Baby Tate - "Sailor Moon (2.0)"
Lérica & Abraham Mateo - "Espinita Clavá"
Lewis Capaldi - "Forget Me"
Lil PJ - "Reaching"
Marauda & Scarlxrd - "HEAVE"
MAX - "IT'S YOU" ft. keshi
Meghan Trainor - "Don't I Make It Look Easy"
Michael Ray - "The Chair (The Bootlegger Sessions)"
Mimoza - "Madly"
Nessa Barrett - "madhouse"
NOTD & Quinn XCII - "Less I Know"
P Yungin - "On A Shirt"
Ryan Cabrera - "Worth It"
Sam Creighton - "Wannabe"
Saucy Santana - "I'm Too Much"
Selfmxdebless - "deadliest sea"
Sevyn Streeter - "23"
Trevor Daniel - "Story"
Unlike Pluto - "Question"
wifisfuneral - "Ahhhhh"
YG - "Alone"
9/13
Big Scarr - "Havin Fun"
Tee Grizzley - "Robbery Part 4"
9/14
雲浩影 (Cloud Wan) - "密切接觸者 (Close Contact)"
Jayde - "​all i wanted"
​will hyde & Jess Benko - "kiss me before u go."
9/15
AB6IX & Reiley - "Moonlight"
Anne-Marie & Aitch - "Psycho"
Antonio José - "Sin Buscarte"
Bill Wurtz - "where i've been"
Brandon Kai - "On My Life"
黃妍 (Cath Wong) - "7月24日大道 (July 24th Avenue)"
Gareth.T - "​buzzcut"
Hotboy Wes - "Master P"
Niceboy Ed - Life You Lead
Pedro Capó - "Volver a Casa"
Ptazeta - "Ponte Pal XXX"
TINI & Tiago PZK - "El Último Beso"
Young King Slaton - "September (Freestyle)"
黃凱逸 (Zelos Wong) - "晚泣 (Night Weep)"
9/16
Amanda Tenfjord - "AMAN"
B-Lovee, Ice Spice, Skillibeng & J.I the Prince of N.Y - "One Time"
Babyface & Queen Naija - "Game Over"
BLEU & Nicki Minaj - "Love In The Way"
Charlie Puth - "I Don't Think That I Like Her"
Fredo Bang - "Bee Crazy"
Craig David & Galantis - "DNA, Pt. 2"
​cupcakKe, Erica Banks & Tweeday - "HDBG (Shemix)"
David Guetta & Bebe Rexha - "I'm Good (Blue) [Stage Mix]"
Fresco Trey - "7/11"
Futuristic - "Hate Me Now" ft. Ryan Oates
Kaash Paige & 6LACK - "Miss My Dawgs"
Kiana Ledé - "Irresponsible"
gavn! - "High"
G Herbo - "Blues" ft. Future
Genezio - "Réveil"
​gigi - "Glue"
GOON DES GARCONS* - "​labyrinth"
guardin - "geronimo"
ILLENIUM & Skylar Grey - "From The Ashes"
Ingrid Laien & Los Del Fino - "Amor Voy a Salir con una Prima 2"
Jackii Kennedy - "I Hate Florida" ft. boyband
Jahmiel - "Unappreciated"
Jeremy Zucker - "I'm So Happy" ft. BENEE
KREAM, Camden Cox & IDEMI - "Chemistry"
Kx5 - "Take Me High"
MAR MEJÍA - "Victory"
Noga Erez - "Nails (Remix)" ft. Missy Elliott
Raw Youngin - "Spinnin'"
RealestK - "One 4 U"
Selfmxdebless - "EMERGENCY"
Unlike Pluto - "Reset Rewind"
周殷廷 (Yan Ting) - "意外現場 (METANOIA)"
9/18
周國賢 (Endy Chow) - "銀河特快之旅 (Galaxy Express)"
9/19
Gucci Mane, BiC Fizzle & BigWalkDog - "Red Flag"
NateWantsToBattle - "Scrap Heap" ft. Ghost Fight
MC 張天賦 (Cheung Tinfu) - "乾 (Drink Up)"
9/20
Big Scarr - "Try Being Me"
FMK - "Buscando un Amor"
Kwabs - "Hurt a Little"
Tee Grizzley - "Jay & Twan 1"
9/21
BIG30 - "No Love"
Emotional Oranges & Unusual Demont - "Cardigan"
Icewear Vezzo - "They Can't FWM"
Kany García & Christian Nodal - "La Siguiente"
Paola Guanche - "Prohibido"
Polimá WestCoast & J Balvin - "KAWAII"
Rozzi - "Past Life" ft. PJ Morton
WOS - "PUAJ (sesión)"
Zolita - "20 Questions"
9/22
22Gz - "Max Out" ft. Shawny Binladen
Aitana - "Otra Vez"
Alex Ponce - "quédate" ft. Thyago
許廷鏗 (Alfred Hui) - "亻言 (Anthropology)"
Boza & Beéle - "Qué Prefieres?"
Ca7riel & Paco Amoroso - "PARA AFUERA"
Carlos Rivera - "Digan Lo Que Digan"
ECKO - "Subiendo De Nivel"
Hannah Jadagu - "Say It Now"
Hotboy Wes - "Renegade" ft. Finesse2Tymes
衛蘭 (Janice Vidal) - "我的視角 (My POV)"
Lil Nas X - "STAR WALKIN"
Ovi, Kim Loaiza & Pailita - "Después de las 12 (Remix)" ft. Grupo Firme
Rauw Alejandro & Baby Rasta - "PUNTO 40"
Sam Smith - "Unholy" ft. Kim Petras
Stella Smyth - "NASCAR"
Stormzy - "MEL MADE ME DO IT"
Ventino - "No Se Me Ve Tan Mal (NSMVTM)"
William Singe, VEDO & J-SoL - "R4L (ready 4 luv)" ft. Mishon

9/23
3Breezy - "Sneaky Link"
Ally Salort - "Late Night Talking"
​Amelia Moore & ASTN - "next door"
Anfa Rose - "How Many Times"
Armani Caesar - "Paula Deen" ft. Westside Gunn
Armin van Buuren & Diane Warren - "Live on Love" ft. My Marianne
Aya Nakamura - "VIP"
Ayelle - "Get Away"
Ayzha Nyree - "Long Night"
Baby Tate - "Ain't No Love" ft. 2 Chainz
Carson Lueders - "Toxic" ft. Quavo
CEO Trayle - "Bit Wit The Fangs" ft. Gunna & Nechie
Channel Tres - "No Limit"
DaBoyDame - "Hood Go Crazy" ft. Jeezy, Yo Gotti & Project Poppa
Darell & Omar Montes - "La Bruja"
David Guetta & Bebe Rexha - "I'm Good (Blue) [Cedric Gervais Remix]"
David Guetta & Bebe Rexha - "I'm Good (Blue) [Cedric Gervais Extended Remix]"
Dayglow - "Second Nature"
EVAN GIIA - "Momentum"
Fabolous & Dave East - "BACH TO BACH"
FRVRFRIDAY - "ALL EARS"
GIRLI - "I Really F**ked It Up"
GIVĒON - "Time"
GloRilla & Cardi B - "Tomorrow 2"
GOON DES GARCONS* - "​vibrance_freestyl v.1.wav"
Jake Miller - "Leave My Heart Alone"
JAY MAX - "A Solas" ft. West Blanco
Jnr Choi - "TICK TOCK"
Jon Vinyl - "FTU"
Jordan Davis - "Midnight Crisis" ft. Danielle Bradberry
Kenzo B - "Sanctioned"
Khalid - "Satellite"
Kordhell & Scarlxrd - "MISS ME?"
Lansdowne - "Medicine"
Lil PJ & Fredo Bang - "Big Poppin"
​little image - "LUNGS BURN"
Lizzo - "2 Be Loved (Am I Ready) [PNAU Remix]"
Lul Bob - "Victim"
Mike Posner - "I'm Not Dead Yet"
Mr Eazi, DJ Tarico & Joey B - "Patek"
MUST DIE! - "U SHOULD KNOW"
Nate Smith - "I Found You"
Nikita Karmen - "My First Rodeo"
Noah Cyrus & Billy Ray Cyrus - "Noah (Stand Still)"
Odeal - "BE FREE"
Odeal - "PDF"
Pentatonix - "Prayers For This World"
Phony Ppl - "Nowhere But Up"
Pol Granch - "Nena"
Poppy - "FYB"
Powfu & Jomie - "watch me miss"
Quinn XCII - "Common" ft. Big Sean
Rileyy Lanez - "One of Them Nights"
Selfmxdebless - "KY$ ON COCAINE"
Shania Twain - "Waking Up Dreaming"
SipTee - "Master P" ft. Roi
SiR - "Nothing Even Matters"
Tears For Fears & Lil Baby - "The World Is Yours To Take"
Toosii - "Heartaches"
Tory Lanez - "Why Did I"
Transviolet - "Devils"
Unlike Pluto - "Dread"
VIZE & R3HAB - "One Last Time"
吳青峰 (Wu Qing Feng) - "(......催眠大師) (......The Great Hypnotist)" ft. Les Choristes
Xloudy - "Do Wh4t I W4nt" ft. Ace Villain
Yung Gravy, bbno$ & Rich Brian - "C'est La Vie"
9/27
Big Scarr - "Anotha 1"
FEYZAL - "Long Way Home"
Groundbreaking - "Woke"
Tee Grizzley - "Ms. Evans 1"
9/28
3AM - "Distancia"
Baby Queen - "Lazy"
Ciara - "Better Thangs" ft. Summer Walker
Cootie - "2Tone" ft. YoungBoy Never Broke Again
Dylan Sinclair, DESTIN CONRAD & Jvck James - "Open (Remix)"
GHENGAR - "COUNT DANKULA"
glaive - "three wheels and it still drives!"
Icewear Vezzo - "Richer"
Lil Poppa - "Money Call"
Lil Pump - "Mosh Pit"
Lucy Dacus - "Home Again"
Lucy Dacus - "It's Too Late"
Noriel - "7D"
Paramore - "This Is Why"
Skyler Acord - "knew it all along"
YSB Tril - "Applause"
YXNG K.A - "Face My Fears"
9/29
Anuel AA - "La2blea"
Arctic Monkeys - "Body Paint"
Ed Sheeran - "Celestial"
Farruko & Ankhal - "Nazareno (Remix)"
Ingratax - "VELOZzzz"
Kenia OS - "Mía Mía"
Lyanno & Young Miko - "SALVAJE"
Maluma - "Junio"
mansonvibes - "It’s a sin."
Natti Natasha & María Becerra - "LOKITA"
Rusherking & Dread Mar I - "Perfecta"
Wisin & Yandel & ROSALÍA - "Besos Moja2"
9/30
24kGoldn - "Mistakes"
Aloe Blacc - "Free"
Alok - "Slow It Down"
Andy Bull - "Dying Star"
Arin Ray - "Stay For The Night (Rockstar Energy Studios Freestyle)"
Bilmuri - "CORN-FED YETIS"
CG5 - "Glamorous"
Charlie Puth - "Charlie Be Quiet!"
Charly Black & Ria Rania - "Flea Market"
Chase McDaniel - "Your Daughter"
Christina Aguilera - "No Es Que Te Extrañe"
Cory - "Vértigo"
​dvsn - "What’s Up" ft. Jagged Edge
GOON DES GARCONS* - "​elite (crossover)"
HARDY - "Jack"
HD4President - "Big Booty" ft. DJ Chose
Hitkidd & Enchanting - "Kater To Me"
Jake Cornell - "​personal"
Jake Wesley Rogers - "Hindsight"
Jhosy, Beéle & Manuel Turizo - "Aurora (Remix)"
Jon Langston - "Give You My All"
Kenyon Dixon - "Getting Late"
Kenzo B - "No Tweakin"
Kleo (Pop) - "Beautiful Life"
Kranium - "Without You" ft. Queen Naija
Leah Kate - "Monster"
Louis Tomlinson - "Bigger Than Me (Live from Milan)"
LUDMILLA, Sean Paul & Topo La Maskara - "Tic Tac"
M.I.A. - "Beep"
Mackenzie Carpenter - "Huntin’ Season"
Maddy Hicks - "Picture You Naked"
Mokita - "Color Me In"
Nakkia Gold - "Let You Know"
Neek Bucks & 2 Chainz - "Mask Up"
Nick Wayne - "Sunny Side Up"
Oriana - "SOLA"
Quavo & Takeoff - "Nothing Changed"
RealestK - "Bruce Wayne"
Roddy Ricch - "Stop Breathing"
Russell Dickerson - "I Wonder"
RyFy & Ye Ali - "90s Baby"
​Sidney Bird - "Over Me"
skaiwater - "‎boys don’t cry"
Sofía Valdés & Pink Sweat$ - "Broken"
Tate McRae - "uh oh"
Teddy Swims - "Someone Who Loved You"
The Stupendium - "Open the Sky"
Tommy Newport & Jazz Cartier - "Jackpot"
Valencia Grace - "There I Said It"
William Singe - "Catch My Breath"
Zach Hood - "​when she was mine"1Embed