5 ContributorsNew Music Friday 04/28/17 LyricsPhoenix - J-Boy
DJ Khaled - I'm the One feat. Justin Bieber, Quavo, Chance The Rapper & Lil Wayne
Katy Perry - Bon App√©tit feat. Migos
Kygo - First Time feat. Ellie Goulding
Logic - 1-800-273-8255 feat. Alessia Cara & Khalid
Mary J. Blige - Strength of a Woman
ODESZA - Line of Sight feat. WYNNE & Mansionair
Gorillaz - Submission feat. Danny Brown & Kelela
The Vamps & Martin Jensen - Middle of the Night
OneRepublic - No Vacancy
Imagine Dragons - Thunder
Hailee Steinfeld - Most Girls
Cashmere Cat - Quit feat. Ariana Grande
Foster The People - S.H.C
Wale - My Love feat. Major Lazer, WizKid & Dua Lipa
Niia - Nobody
Skip Marley - Calm Down
Machine Gun Kelly - Let You Go
Tove Styrke - Say My Name
Fall Out Boy - Young and Menace
New Found Glory - Call Me Anti-Social
Sylvan Esso - The Glow
Allie X - Paper Love
Portugal. The Man - Number One feat. Richie Havens & Son Little
The Japanese House - Saw You in a Dream
Whethan - love gang feat. Charli XCX
Prince - Electric Intercourse
The Chainsmokers & Coldplay - Something Just Like This (Jai Wolf Remix)
Sandro Cavazza - So Much Better
Jennifer Hudson - Remember Me (Ryan Riback Remix) üêö
Emmit Fenn - 1995
Molly Kate Kestner - It's You
FRND - Be Happy
Sean Paul - Body feat. Migos
Jerry Folk - Purple Feelings feat. Rainsford
Russ - Cherry Hill
Steve Aoki & DVBBS - Without U feat. 2 Chainz
SZA - Love Galore feat. Travis Scott
A$AP Mob - Wrong feat. A$AP Rocky & A$AP Ferg
Majid Jordan - Phases
Kid Ink - Supersoaka
AD & Sorry Jaynari - Better feat. Wiz Khalifa & Tory Lanez
Tom Walker - Blessings
Sigrid - Dynamite
Ingrid Michaelson - Celebrate feat. AJR
David Archuleta - Up All Night
Jasmine Thompson - Old Friends
Bantu - Juice
The War On Drugs - Thinking of a Place
Rafferty - Girl, You'll Be a Woman Soon
X Ambassadors - Torches
Shakey Graves - Nobody's Fool
Feist - Any Party
Emily Vaughn - Mood
Ruth B. - Dandelions
Gnash - belong feat. DENM
Lucas Estrada & Alex Alexander - A Little Thing We've Got feat. Kozze
Benny Cassette - Maxine
Illenium & Kerli - Sound of Walking Away
Fortunes. - Linen
Reece - Alone
Anik Khan - Don't Behave
Hazel English - Love Is Dead
1ST VOWS - Body Talk
Juanes - Goodbye For NowEmbed