1 ContributorNew Music Friday 12/17/21 LyricsRoddy Ricch - 25 million
FKA twigs - Tears In The Club (feat. The Weeknd)
6LACK - Rent Free
Burna Boy - B. D‚ÄôOR (feat. Wizkid)
SAINt JHN - The Best Part of Life
Aaliyah - Poison
24kGoldn - More Than Friends
Camilo - Pesadilla
RealestK - Toxic
Tierra Whack - Heaven
Roddy Ricch - thailand
Kodak Black - Closure
Rvssian - M&M (with Future feat. Lil Baby)
Jhen√© Aiko - Wrap Me Up
NLE Choppa - Drop Shit
Joyner Lucas - My Escape
EST Gee - Dead Wrong (feat. Future)
Rebecca Black - Read My Mind
Arizona Zervas - SNOWMAN
Rxseboy - Leaving (feat. the bootleg boy & Heroe)
Preme - Make a Mall
Melii - Hey Stranger
Scorey - Die Young
Oliver Tree - Life Goes On (feat. Trippie Redd & Ski Mask The Slump God)
midwxst - No Smoke (feat. DC The Don)
Imanbek - Go Crazy
Saucy Santana - Shisha
Hayd - What Did I Do?
Alex Warren - Remember me Happy
Madison Ryann Ward - Anchor
Steve Aoki - Stars Don't Shine (feat. Global Dan)
Jacques Greene - Leave Here
Yot Club - Deer Island
Big Thief - No Reason
Vince Gill - Love Changes Everything - From The Motion Picture American Underdog
Lil Durk - Broadway Girls (feat. Morgan Wallen)
Joe Jonas - Go It Alone (From Rumble)
Thomas Day - The New Me
david hugo - How to Love Other People
Naomi Sharon - Hills
Chief Keef - Tuxedo
Bobby Shmurda - Shmoney (feat. Quavo & Rowdy Rebel)
yvngxchris - EXTRAVAGANT
Pritty - Soldier, Like Me
Hailey Knox - Gucci Prada Balenciaga
Worry Club - Pretty Face
MisterWives - Stepped On A Bee üïí
NCT 2021 - Beautiful
Yung Bleu - Welcome Back, Dummy
Capella Grey - Talk Nice
Casper Magico - Karma
Pia Mia - Whole Thing üïí
Alok - Squid Game (Let's Play)
Kaskade - ICE v3
whiterosemoxie - No Kure
EXUM - Room #624 (Married 2 My Mind)
HARRY WAS HERE - Weight of the World
Arlie - crashing down
Best Coast - Leading
DreamDoll - Oh Shhh
Benny The Butcher - Mr. Pyrex Man
Waxahatchee - Tomorrow
Animal Collective - Walker
Edith Whiskers - Quiet Zone
LAYNE - Time Machine
Big Time Rush - Call It Like I See It
Emilia - De Enero a Diciembre
sammy rash - best friends
Chris Webby - We Up (feat. DMX)
Westsidejhitt - Bobby Brown (Feat. Olo Pack)
HIRA - Need 2 ‚Äô19
NEFFEX - Dreaming On
Sophie Powers - Clearview
Dounia - Ice Rink
NEIL FRANCES - where I become someone
Gaullin - On My Way
angelus - who knows?
1nonly - Come Thru (feat. Shady Moon & Ciscaux)
Eli Fross - Steppas Freestyle (feat. Sleepy Hallow)
Sally Sossa - Moncler Coat
Cal in Red - Got What You Wanted
ILIRA - Flowers
Smrtdeath - great
Kameron - No Bottom
Miynt - Station station
Junior H - Nac√≠ Para Amarte
RZA - Quentin Tarantino
Project Youngin - Mad That I'm Rich (feat. FCG Heem) üêö
Besomorph - Slow Nights
Davina Michelle - HYPER
Rozei - Way Back When
The Ballroom Thieves - Shine
Valley Boy - Cozy
BLOND:ISH - Sint Maarten
Adam Buxton - Tippy Toes (with Fancy Feelings feat. DSCOSTU) - BONUS TRACK
Passion - Shine Like Stars - Live
Naira Marley - Kojosese
SportVVS - Never Worried
Poundside Pop - Feeling Myself (feat. DJ Drama) üïí
Derez De‚ÄôShon - Abandoned üïíEmbed